"county","year","totalpopulation","unincorporatedpop","incorporatedpop","average_yearly_wage","lowtiermedianhomevalue","hightiermedianhomevalue","singlefamilymedianhomevalue","value_inches"
"Alachua",2019,267306,106299,161007,49116,123073,314621,208584,"52.82"
"Alachua",2018,263291,104904,158387,47858,114833,300367,197879,"66.46"
"Alachua",2017,260003,103810,156193,45705,107574,288320,187389,"63.47"
"Alachua",2016,257062,102298,154764,44257,98319,268422,173570,"46.39"
"Alachua",2015,254893,101621,153272,43598,92215,256906,164952,"52.27"
"Alachua",2014,250730,100380,150350,42691,88593,248717,158633,"58.97"
"Alachua",2013,248002,99282,148720,41588,83601,235069,149074,"52.13"
"Alachua",2010,247336,98991,148345,39688,102223,269990,172110,"45"
"Alachua",2009,256232,107260,148972,39080,110449,288381,183571,"53.1"
"Alachua",2008,252388,105051,147337,37469,125463,325363,206437,"45.17"
"Alachua",2007,247561,103217,144344,36456,135485,354738,224103,"44.1"
"Alachua",2006,243779,101950,141829,34748,130667,345131,217399,"37.3"
"Alachua",2005,240764,100507,140257,33145,111818,301074,187998,"54.2"
"Alachua",2004,236174,98755,137419,30939,95977,260733,162329,"64.46"
"Alachua",2003,231296,95161,136135,28867,83740,228059,141447,"53.7"
"Alachua",2002,228607,111939,116668,27648,76757,210486,129499,"58.4"
"Alachua",2001,222935,108532,114403,26917,72233,198921,121316,"45.63"
"Alachua",2020,271588,107807,163781,53345,132096,329247,221279,"53.53"
"Alachua",2012,246770,98850,147920,40775,82088,230283,144969,"59.51"
"Alachua",2011,247337,98928,148409,40206,88550,243519,154451,"43.04"
"Baker",2019,28249,20838,7411,33855,103360,273003,183579,"39.8"
"Baker",2018,27652,20463,7189,33877,99162,262403,175721,"52.8"
"Baker",2017,27191,20211,6980,33240,91936,244925,163166,"55.18"
"Baker",2016,26965,20071,6894,32118,83988,225115,149259,"45.27"
"Baker",2015,27017,20152,6865,31746,73998,201558,132288,"43.93"
"Baker",2014,26991,20188,6803,31589,66531,182723,119204,"62.13"
"Baker",2013,26881,20088,6793,30955,60193,165902,108046,"51.31"
"Baker",2012,26938,20155,6783,30616,55689,153836,99876,"61.23"
"Baker",2011,26927,20147,6780,30733,55781,154098,99638,"49.36"
"Baker",2010,27115,20304,6811,29649,59521,165107,106369,"41.2"
"Baker",2009,25899,19487,6412,29509,65049,181501,116914,"53.28"
"Baker",2008,25890,19564,6326,29124,75324,211041,136274,"53.73"
"Baker",2007,25623,19348,6275,28338,88792,250200,161143,"44.56"
"Baker",2006,25004,19105,5899,28143,91632,259273,166659,"41.39"
"Baker",2005,23953,18270,5683,27483,80196,230740,145879,"58.9"
"Baker",2004,23963,18456,5507,26503,65047,188634,118404,"60.88"
"Baker",2003,23383,18035,5348,25370,56025,161746,102230,"56.98"
"Baker",2002,22992,17818,5174,24108,51104,149413,94328,"55.88"
"Baker",2001,22562,17492,5070,23903,44580,135928,84900,"44.01"
"Baker",2020,28532,20889,7643,36345,105031,279667,188866,"53.53"
"Bay",2020,174410,77729,96681,45967,157971,373321,230015,"54.24"
"Bay",2019,167283,75986,91297,43649,143829,350864,212196,"47.63"
"Bay",2018,181199,78463,102736,40652,140110,342985,207981,"70.18"
"Bay",2017,178820,77279,101541,39317,127651,318654,191755,"55.45"
"Bay",2016,176016,75806,100210,38770,121034,308579,183701,"63.98"
"Bay",2015,173310,76398,96912,37790,114011,297223,176054,"57.66"
"Bay",2014,170781,74720,96061,36828,108755,287448,169160,"66.08"
"Bay",2013,169866,74517,95349,35755,102132,271963,159102,"75.63"
"Bay",2012,169392,74417,94975,35546,98683,263999,154009,"58.3"
"Bay",2010,168852,74139,94713,35948,116284,296874,176230,"46.66"
"Bay",2009,169562,72558,97004,34857,125403,329869,190814,"61.62"
"Bay",2008,169307,66539,102768,34361,143700,381027,218231,"58.84"
"Bay",2007,167631,66728,100903,33950,155808,419706,238102,"40.96"
"Bay",2006,165515,65551,99964,33341,159522,442988,247950,"43.72"
"Bay",2005,161721,64186,97535,31894,136022,392382,214211,"58.16"
"Bay",2004,158437,62762,95675,30257,104998,301210,165994,"54.79"
"Bay",2003,154827,61258,93569,29127,88587,253578,140813,"71.85"
"Bay",2002,152186,60135,92051,27448,80938,234662,129450,"59.21"
"Bay",2001,150287,58994,91293,26433,77025,224764,123711,"47.7"
"Bay",2011,169278,74357,94921,35906,103462,271602,158850,"45.73"
"Bradford",2020,28725,21708,7017,39784,73142,245600,143161,"65.02"
"Bradford",2019,28682,21725,6957,37634,71532,239158,138740,"46.42"
"Bradford",2018,28057,21200,6857,37468,67892,230865,132973,"60.87"
"Bradford",2017,27642,20598,7044,35630,63264,217546,125373,"63.27"
"Bradford",2016,27440,20398,7042,35692,59221,204385,118243,"43.58"
"Bradford",2015,27310,20358,6952,35763,54638,188066,108588,"48.82"
"Bradford",2014,27323,20259,7064,34199,49998,171689,98513,"56.05"
"Bradford",2013,27217,20130,7087,32678,45468,156726,89943,"49.81"
"Bradford",2012,27239,20264,6975,31467,41835,144776,83001,"64.37"
"Bradford",2011,28662,21677,6985,30838,41181,142930,82290,"48.39"
"Bradford",2010,28520,21503,7017,30769,43548,151634,87147,"42.9"
"Bradford",2009,29085,21701,7384,30880,47199,165667,94994,"56.52"
"Bradford",2008,29059,21509,7550,30670,55263,195462,111158,"47.89"
"Bradford",2007,29055,21463,7592,30034,64116,230062,130114,"43.04"
"Bradford",2006,28551,21051,7500,29425,65099,238114,133704,"38.92"
"Bradford",2005,28118,20847,7271,29666,56210,210151,116695,"54.2"
"Bradford",2004,27740,20706,7034,28489,45070,172548,95621,"62.06"
"Bradford",2003,26972,19999,6973,27179,38656,148371,83449,"57.52"
"Bradford",2002,26517,19410,7107,27106,35190,136742,77207,"56.45"
"Bradford",2001,26080,18973,7107,26350,32498,126547,71715,"43.83"
"Brevard",2020,606671,225616,381055,55572,158940,381371,239553,"55.02"
"Brevard",2019,594469,221729,372740,51748,149940,363650,226942,"56.2"
"Brevard",2018,583563,217902,365661,49685,142222,352359,218059,"46.72"
"Brevard",2017,575211,215142,360069,48469,130338,333257,203203,"58.95"
"Brevard",2016,568919,212740,356179,46778,115592,307048,183626,"56.28"
"Brevard",2015,561714,210276,351438,45978,101082,277435,163714,"48.55"
"Brevard",2014,552427,207313,345114,44484,90591,254934,148864,"59.97"
"Brevard",2013,548424,206365,342059,44364,81038,233323,134018,"46.16"
"Brevard",2012,545625,205690,339935,44153,73043,213833,121226,"41.56"
"Brevard",2010,543376,206332,337044,43770,83155,234362,135837,"39.19"
"Brevard",2009,555657,212749,342908,43111,92543,255523,149039,"44.04"
"Brevard",2008,556213,212492,343721,42089,118133,309923,183791,"60.34"
"Brevard",2007,552109,210967,341142,40975,150348,386364,232215,"43.39"
"Brevard",2006,543050,213667,329383,39778,165982,429559,261044,"41.61"
"Brevard",2005,531970,210260,321710,38287,141009,382825,225766,"60.62"
"Brevard",2004,521422,208239,313183,37912,106765,295853,173318,"54.77"
"Brevard",2003,507810,204689,303121,35280,88276,240490,143272,"46.73"
"Brevard",2002,494102,198121,295981,33913,78598,213713,127895,"56.31"
"Brevard",2001,485178,193121,292057,32798,71607,194480,117156,"57.03"
"Brevard",2011,545184,206763,338421,44185,72713,211694,120477,"50.45"
"Broward",2019,1919644,15304,1904340,54643,145703,454329,331833,"61.36"
"Broward",2018,1897976,15120,1882856,52977,139619,443035,321243,"53"
"Broward",2017,1873970,15006,1858964,51259,130404,422556,302043,"67.98"
"Broward",2016,1854513,14759,1839754,49548,120629,401400,281879,"52.77"
"Broward",2015,1827367,14515,1812852,48767,112315,380981,263397,"52.54"
"Broward",2014,1803903,14403,1789500,47012,105888,365609,248511,"58.14"
"Broward",2013,1784715,14699,1770016,45598,91706,327390,217878,"64.03"
"Broward",2010,1748066,17088,1730978,43811,81642,298132,200405,"55.14"
"Broward",2009,1744922,12955,1731967,43159,89597,312048,210529,"54.73"
"Broward",2008,1758494,12750,1745744,42718,120309,396198,271227,"53.95"
"Broward",2007,1765707,14080,1751627,42087,153661,505474,345161,"54.05"
"Broward",2006,1753162,27773,1725389,41276,156292,526765,355442,"46.03"
"Broward",2005,1740987,44870,1696117,39378,130611,452968,300050,"58.46"
"Broward",2004,1723131,83359,1639772,37905,104862,364796,241251,"47.98"
"Broward",2003,1698425,88063,1610362,35911,89580,310930,206370,"61.53"
"Broward",2002,1669153,95415,1573738,34475,78721,275282,182073,"57.26"
"Broward",2001,1649925,112605,1537320,33966,67651,243448,157649,"62.26"
"Broward",2020,1932212,15375,1916837,59036,152726,472591,346539,"53.37"
"Broward",2012,1771099,16607,1754492,45051,78130,288521,190500,"67.51"
"Broward",2011,1753162,16917,1736245,44469,75887,282325,187486,"50.31"
"Calhoun",2020,14489,11539,2950,35191,45497,192165,109617,"78.56"
"Calhoun",2019,14067,11136,2931,33547,44104,187633,105470,"45.64"
"Calhoun",2018,15093,12030,3063,32746,42894,181446,102023,"70.79"
"Calhoun",2017,15001,11943,3058,32057,40933,170219,97400,"56.64"
"Calhoun",2016,14580,11553,3027,29059,37426,156127,88408,"59.05"
"Calhoun",2015,14549,11513,3036,30811,33790,139283,78370,"56.03"
"Calhoun",2014,14592,11528,3064,29911,30671,125716,70298,"64.78"
"Calhoun",2013,14621,11554,3067,29469,27510,113768,63742,"68.41"
"Calhoun",2012,14641,11598,3043,29194,24969,103803,57498,"52.08"
"Calhoun",2011,14685,11639,3046,27861,23684,100982,55304,"39.9"
"Calhoun",2010,14625,11575,3050,27999,24959,105078,58610,"46.9"
"Calhoun",2009,14601,11580,3021,27601,26606,112131,63444,"63.23"
"Calhoun",2008,14310,11302,3008,27291,31076,129667,73915,"59.94"
"Calhoun",2007,14477,11436,3041,27445,35993,154357,85963,"38.67"
"Calhoun",2006,14113,11075,3038,26709,35119,153622,83873,"43.72"
"Calhoun",2005,13945,10933,3012,24620,34333,136507,75834,"62.58"
"Calhoun",2004,13610,10610,3000,23497,NULL,NULL,NULL,"53.85"
"Calhoun",2003,13439,10469,2970,23280,NULL,NULL,NULL,"62.6"
"Calhoun",2002,13231,10229,3002,22354,NULL,NULL,NULL,"64.19"
"Calhoun",2001,13073,10077,2996,22066,NULL,NULL,NULL,"49.84"
"Charlotte",2020,187904,167499,20405,43356,157457,374727,239463,"65.11"
"Charlotte",2019,181770,161809,19961,40350,151832,364545,231399,"55.01"
"Charlotte",2018,177987,158500,19487,38922,144250,352075,222048,"56.29"
"Charlotte",2017,172720,153882,18838,37707,135281,338520,210380,"57.34"
"Charlotte",2016,170450,152082,18368,36356,124134,319442,195990,"59.51"
"Charlotte",2015,167141,149466,17675,35668,109351,292967,176089,"54.69"
"Charlotte",2014,164467,146980,17487,34559,98888,270950,161251,"52.84"
"Charlotte",2013,163679,146592,17087,34046,89537,252508,147542,"57.07"
"Charlotte",2012,163357,146373,16984,33218,78671,230292,130396,"49.99"
"Charlotte",2011,160463,143722,16741,32830,76505,228481,127322,"46.4"
"Charlotte",2010,159978,143337,16641,32414,84737,250638,140120,"52.32"
"Charlotte",2009,165455,148466,16989,32563,91920,269660,148316,"45.38"
"Charlotte",2008,165781,148130,17651,32927,112295,318681,175550,"50.95"
"Charlotte",2007,164584,147140,17444,32833,136697,384142,215102,"33.33"
"Charlotte",2006,160315,143363,16952,32370,153726,431550,245757,"46.19"
"Charlotte",2005,154030,137775,16255,31937,129332,376853,209002,"59.04"
"Charlotte",2004,156985,139817,17168,29998,101484,302260,166537,"50.87"
"Charlotte",2003,151994,135403,16591,25627,85256,255995,141413,"62.89"
"Charlotte",2002,148521,132401,16120,26119,75183,225485,124493,"52.92"
"Charlotte",2001,144571,129335,15236,25404,68833,205983,113859,"50.5"
"Citrus",2020,149383,138818,10565,40328,119898,282260,178992,"56.88"
"Citrus",2019,147744,136970,10774,38122,110157,265127,166272,"55.2"
"Citrus",2018,145721,135008,10713,37288,102963,254560,158431,"66.26"
"Citrus",2017,143801,133395,10406,36520,91292,233969,144371,"50.72"
"Citrus",2016,143054,132660,10394,35475,80214,214776,129828,"52.07"
"Citrus",2015,141501,131162,10339,35716,73815,202842,120496,"48.54"
"Citrus",2014,140798,130517,10281,35142,68080,190453,111187,"63.49"
"Citrus",2013,140519,130277,10242,35556,66989,189401,109318,"48.71"
"Citrus",2012,140761,130490,10271,35470,64238,184903,105718,"57.33"
"Citrus",2011,140956,130646,10310,35028,68007,197080,111847,"48.13"
"Citrus",2010,141236,130918,10318,34679,77225,219961,125483,"47.76"
"Citrus",2009,142609,131763,10846,33564,84895,238585,136394,"49.31"
"Citrus",2008,142043,131095,10948,31664,100141,276564,159017,"47.03"
"Citrus",2007,140124,129101,11023,31729,116816,316223,184402,"50.04"
"Citrus",2006,136749,125772,10977,31438,119099,320931,189998,"41.37"
"Citrus",2005,132635,121717,10918,30265,95934,268433,155574,"54.18"
"Citrus",2004,129110,118320,10790,28582,77716,220004,126270,"59.17"
"Citrus",2003,125804,115128,10676,27616,69493,198417,113798,"61.85"
"Citrus",2002,123008,112627,10381,25958,64966,186094,106533,"62.54"
"Citrus",2001,120471,110185,10286,25954,61665,176727,101631,"50.45"
"Clay",2020,219575,200655,18920,43236,179379,319123,235993,"48.84"
"Clay",2019,215246,196607,18639,40435,170115,306723,225746,"46.96"
"Clay",2018,212034,193461,18573,39490,159740,295686,214746,"60.76"
"Clay",2017,208549,190210,18339,38122,143903,274280,195884,"65.52"
"Clay",2016,205321,187142,18179,36742,131853,256032,180852,"41.76"
"Clay",2015,201277,183611,17666,35941,125142,247400,173767,"46.29"
"Clay",2014,197403,179853,17550,35055,120272,241756,168046,"54.23"
"Clay",2013,192843,175387,17456,33780,109742,226130,155355,"51.66"
"Clay",2012,192071,174677,17394,33430,102282,216546,147783,"60.03"
"Clay",2011,191143,173754,17389,32866,106748,223366,152757,"46.45"
"Clay",2010,190865,173446,17419,32238,121977,247241,170619,"39.31"
"Clay",2009,185208,167545,17663,31840,133806,268447,185510,"58.4"
"Clay",2008,185168,167484,17684,31297,152322,304916,210194,"51.82"
"Clay",2007,184644,167005,17639,31079,158444,321887,221757,"45.54"
"Clay",2006,176901,159442,17459,30475,151043,310426,212961,"36.15"
"Clay",2005,169623,152343,17280,29212,128367,267583,182034,"55.76"
"Clay",2004,163461,146401,17060,28033,112223,236615,160607,"58.79"
"Clay",2003,156011,139229,16782,26836,102024,215711,147022,"53.47"
"Clay",2002,149901,133304,16597,23610,96033,203816,138420,"53.68"
"Clay",2001,142838,126420,16418,22782,92316,197004,132883,"48.83"
"Collier",2020,387450,348362,39088,54807,212878,826251,410781,"55.54"
"Collier",2019,376706,338008,38698,50092,208762,810112,400032,"63.78"
"Collier",2018,367347,329501,37846,48697,208380,811747,401381,"54.87"
"Collier",2017,357470,319796,37674,46415,205042,808621,398250,"71.2"
"Collier",2016,350202,313104,37098,45427,202162,814250,398809,"56.92"
"Collier",2015,343802,307120,36682,44985,184859,763093,372009,"53.74"
"Collier",2014,336783,300237,36546,43934,163216,689113,331378,"51.98"
"Collier",2013,333663,297103,36560,43214,145540,625466,295766,"52.41"
"Collier",2012,329849,293343,36506,41778,130409,574133,265952,"52.91"
"Collier",2011,323785,287485,36300,40979,128649,571642,261676,"46.18"
"Collier",2010,321520,285170,36350,40820,137526,607380,278448,"49.94"
"Collier",2009,333032,293909,39123,39808,150813,654718,300679,"48.71"
"Collier",2008,332854,292794,40060,40178,191486,782176,372004,"58.26"
"Collier",2007,333858,294289,39569,41300,236690,936225,454955,"44.91"
"Collier",2006,326658,287442,39216,39320,258761,1024306,499327,"45.07"
"Collier",2005,317788,279124,38664,38211,209233,875968,410002,"57.73"
"Collier",2004,306186,267640,38546,34856,158525,673379,310203,"48.87"
"Collier",2003,292466,254255,38211,33235,139821,594391,270039,"61.18"
"Collier",2002,277457,240093,37364,31507,125428,542664,243207,"53.94"
"Collier",2001,264475,227234,37241,30839,112927,491034,219508,"59.01"
"Columbia",2019,70492,57667,12825,39137,79430,245105,149552,"44.12"
"Columbia",2018,69721,56847,12874,38204,76878,238455,145083,"58.65"
"Columbia",2017,68943,56121,12822,37443,72657,227416,137164,"55.08"
"Columbia",2016,68566,55891,12675,35681,67322,211452,126714,"48"
"Columbia",2015,68163,55603,12560,35620,61194,193082,115485,"48.89"
"Columbia",2014,67826,55263,12563,34888,55348,176018,104788,"66.34"
"Columbia",2013,67489,55000,12489,34054,49904,160078,94729,"55.4"
"Columbia",2012,67729,55102,12627,33535,45563,147023,86647,"64.13"
"Columbia",2011,67528,54911,12617,33289,45599,146495,86528,"48.9"
"Columbia",2010,67531,54918,12613,33989,48587,155935,92225,"45.45"
"Columbia",2009,66409,54750,11659,32912,52325,169229,99810,"51.06"
"Columbia",2008,66121,54304,11817,32132,60691,198214,116604,"49.94"
"Columbia",2007,65373,53514,11859,31779,65968,217676,127775,"40.34"
"Columbia",2006,63538,52156,11382,31361,59365,202884,117449,"42.35"
"Columbia",2005,61466,50341,11125,30196,47996,170107,95764,"57.94"
"Columbia",2004,60453,49373,11080,28820,40352,145490,81272,"63.77"
"Columbia",2003,58890,47830,11060,27339,38504,141853,80003,"59.32"
"Columbia",2002,58372,47683,10689,26780,35554,132991,75047,"52.96"
"Columbia",2001,57066,46628,10438,26720,32721,123045,69430,"43.34"
"Columbia",2020,70617,57709,12908,41138,82130,252532,154936,"56.83"
"DeSoto",2020,37082,29096,7986,40772,82581,239968,140768,"52.6"
"DeSoto",2019,36065,28295,7770,37922,77521,228442,132760,"51.46"
"DeSoto",2018,35520,27847,7673,36489,73222,216366,124503,"57.06"
"DeSoto",2017,35621,27944,7677,35633,67280,200455,114675,"59.5"
"DeSoto",2016,35141,27513,7628,34618,62671,186700,107123,"58.48"
"DeSoto",2015,34777,27167,7610,34549,59772,176112,102468,"57.72"
"DeSoto",2014,34426,26947,7479,33988,54950,163614,95021,"54.09"
"DeSoto",2013,34367,26827,7540,33426,51066,152338,87920,"57.76"
"DeSoto",2012,34408,26823,7585,32839,47293,141900,81647,"51.96"
"DeSoto",2011,34708,27116,7592,31936,48007,144520,83205,"47.46"
"DeSoto",2010,34862,27225,7637,31639,51835,156334,89884,"54.08"
"DeSoto",2009,34792,28053,6739,30846,57213,173550,99199,"45.52"
"DeSoto",2008,34487,27860,6627,29661,68559,208624,118857,"50.96"
"DeSoto",2007,33983,27366,6617,29214,81389,248556,141580,"36.63"
"DeSoto",2006,33164,26409,6755,27991,83126,255434,144879,"42.23"
"DeSoto",2005,32606,25938,6668,26143,70392,220144,122727,"59.91"
"DeSoto",2004,34105,27251,6854,25919,56332,176526,98388,"57.32"
"DeSoto",2003,33713,26853,6860,23890,48347,150063,84611,"57.85"
"DeSoto",2002,32798,26020,6778,23382,44054,136517,77203,"59.21"
"DeSoto",2001,32736,26002,6734,22139,40246,124331,70630,"54.68"
"Dixie",2020,16663,14768,1895,36307,51698,193839,97936,"55.24"
"Dixie",2019,16610,14767,1843,34574,51264,191448,98109,"61.14"
"Dixie",2018,16489,14622,1867,35228,49435,186681,94911,"81.05"
"Dixie",2017,16726,14851,1875,34590,45797,175911,87778,"61.5"
"Dixie",2016,16773,14900,1873,33367,42433,163093,81715,"60.94"
"Dixie",2015,16468,14576,1892,32106,38525,149610,74693,"60.18"
"Dixie",2014,16356,14475,1881,32077,34235,135503,67277,"65.56"
"Dixie",2013,16263,14385,1878,29422,31073,124956,60866,"61.22"
"Dixie",2012,16298,14423,1875,29191,27457,113829,53996,"66.67"
"Dixie",2011,16385,14489,1896,28641,25679,111222,51551,"43.16"
"Dixie",2010,16422,14525,1897,28556,26050,116359,52839,"53.5"
"Dixie",2009,16221,14243,1978,27947,27294,125546,56264,"56.36"
"Dixie",2008,15963,13909,2054,28072,32288,151598,69035,"49.24"
"Dixie",2007,15808,13755,2053,27371,37884,179799,81841,"39.25"
"Dixie",2006,15677,13635,2042,27270,38450,185790,84602,"40.59"
"Dixie",2005,15377,13342,2035,27247,32774,161366,73277,"61.17"
"Dixie",2004,14928,12882,2046,26204,26134,128090,59039,"62.46"
"Dixie",2003,14688,12632,2056,24927,21830,106400,50130,"52.37"
"Dixie",2002,14459,12396,2063,28088,19137,95035,45115,"54.82"
"Dixie",2001,14059,11994,2065,24693,16830,85482,40619,"44.62"
"Duval",2020,982080,0,982080,58829,131192,330519,215168,"53.35"
"Duval",2019,970672,0,970672,54919,122599,313576,202300,"44.04"
"Duval",2018,952861,0,952861,53569,114996,302858,191778,"51.85"
"Duval",2017,936811,0,936811,51828,104649,283441,176524,"59.25"
"Duval",2016,923647,0,923647,50569,94080,262793,161710,"40.36"
"Duval",2015,905574,0,905574,49682,86205,247792,150663,"45.41"
"Duval",2014,890066,0,890066,48811,81519,238997,143966,"56.02"
"Duval",2013,876075,0,876075,47481,74413,222494,131591,"51.56"
"Duval",2012,869729,0,869729,47027,67638,203676,119690,"59.21"
"Duval",2011,864601,0,864601,45556,70822,210080,126603,"45.87"
"Duval",2010,864263,0,864263,45084,84653,237716,147384,"32.25"
"Duval",2009,900518,0,900518,44006,96069,261691,163053,"58.76"
"Duval",2008,904971,0,904971,43724,110982,299800,187411,"51.72"
"Duval",2007,897597,0,897597,43641,121071,330332,205031,"44.11"
"Duval",2006,879235,0,879235,42232,118236,327136,201353,"34.2"
"Duval",2005,861150,0,861150,40095,101231,281733,172506,"55.47"
"Duval",2004,840474,0,840474,38635,87857,244116,149982,"53.31"
"Duval",2003,826279,0,826279,37027,79657,218558,135230,"47.5"
"Duval",2002,809394,0,809394,35279,73684,201557,124501,"52.09"
"Duval",2001,793898,0,793898,33721,68486,186956,115354,"47.68"
"Escambia",2020,323714,266434,57280,48852,98274,309547,168752,"55.16"
"Escambia",2019,321134,264282,56852,45766,92983,293979,158835,"50.54"
"Escambia",2018,318560,262157,56403,44262,86257,280632,149554,"76.28"
"Escambia",2017,313381,257774,55607,42975,78259,261705,138010,"81.89"
"Escambia",2016,309986,254757,55229,41637,72118,245901,128079,"57.47"
"Escambia",2015,306944,252308,54636,40964,68329,234038,121311,"66.45"
"Escambia",2014,303907,249515,54392,39354,65183,226059,116676,"66.69"
"Escambia",2013,301120,247278,53842,38146,62597,218064,112177,"63.32"
"Escambia",2012,299511,245796,53715,38406,60619,212204,108368,"58.33"
"Escambia",2011,299261,245632,53629,37808,63141,215058,112440,"43.26"
"Escambia",2010,297619,243998,53621,36730,72125,235842,125712,"55.89"
"Escambia",2009,312980,256463,56517,36512,75642,245805,130382,"79.39"
"Escambia",2008,313480,256911,56569,35512,84334,273104,143792,"57.32"
"Escambia",2007,311775,255081,56694,34710,92238,301134,158039,"53.95"
"Escambia",2006,309647,252859,56788,33754,93820,316114,162864,"45.59"
"Escambia",2005,303623,247012,56611,32643,80596,276889,140211,"71.47"
"Escambia",2004,307226,249132,58094,30972,67056,226682,115823,"69.9"
"Escambia",2003,303310,245268,58042,29692,61928,207628,107497,"69.71"
"Escambia",2002,299485,241453,58032,28905,59776,199261,103902,"63.84"
"Escambia",2001,296709,238671,58038,28610,58047,194095,101221,"51.27"
"Flagler",2020,114173,16141,98032,38521,191226,378523,246511,"69.11"
"Flagler",2019,110635,15499,95136,36114,184299,368140,238693,"51.5"
"Flagler",2018,107511,14852,92659,35493,174543,355159,228360,"63.98"
"Flagler",2017,105157,14463,90694,34017,165747,343847,218489,"62.41"
"Flagler",2016,103095,14035,89060,33180,152995,325329,203467,"44.06"
"Flagler",2015,101353,13794,87559,32929,140434,308628,189903,"45.03"
"Flagler",2014,99121,13484,85637,31443,133015,297227,180964,"60.81"
"Flagler",2013,97843,13301,84542,31425,117527,270036,161684,"53.6"
"Flagler",2012,97160,13253,83907,31196,103914,248022,145605,"49.02"
"Flagler",2011,96241,13127,83114,30832,106824,257498,149401,"45.96"
"Flagler",2010,95696,13062,82634,30883,115166,277186,160561,"38.36"
"Flagler",2009,94901,12141,82760,30493,126328,308881,177195,"52.31"
"Flagler",2008,95512,12304,83208,30417,155039,378011,218935,"51.85"
"Flagler",2007,93568,14879,78689,30467,183615,442905,258531,"50.06"
"Flagler",2006,89075,12751,76324,30351,197179,474372,278530,"32.89"
"Flagler",2005,78617,12068,66549,32112,167448,410589,236772,"64.55"
"Flagler",2004,69683,10983,58700,30824,132898,332036,188592,"59.11"
"Flagler",2003,61541,10600,50941,28129,110884,280438,159561,"55.86"
"Flagler",2002,56785,10378,46407,26374,97615,248459,143048,"55.72"
"Flagler",2001,53061,9917,43144,24706,91093,231279,133094,"58.52"
"Franklin",2020,11864,6874,4990,34854,125352,613098,297789,"53.02"
"Franklin",2019,12273,7051,5222,33123,119341,595731,286833,"45.87"
"Franklin",2018,12009,7000,5009,31600,115022,579004,279491,"64.79"
"Franklin",2017,12161,6999,5162,30667,109182,550840,266930,"54.77"
"Franklin",2016,11916,6495,5421,30217,102786,520776,252309,"52.4"
"Franklin",2015,11840,6773,5067,30141,99614,502918,244674,"53.11"
"Franklin",2014,11794,6680,5114,29364,95871,491428,238392,"61.67"
"Franklin",2013,11562,6501,5061,29060,90796,474115,229647,"64.97"
"Franklin",2012,11530,6431,5099,28284,84428,450787,215018,"56.58"
"Franklin",2011,11527,6551,4976,28100,84505,463362,215380,"39.97"
"Franklin",2010,11549,6540,5009,28528,89145,496056,226158,"50.67"
"Franklin",2009,12414,8577,3837,29039,96794,547398,244389,"63.13"
"Franklin",2008,12331,8505,3826,28215,113888,653042,287706,"48.44"
"Franklin",2007,12249,8426,3823,27186,134805,778688,342517,"36.57"
"Franklin",2006,11916,8127,3789,27067,138944,809643,354566,"45.83"
"Franklin",2005,10845,7061,3784,26108,118796,703958,303326,"58.09"
"Franklin",2004,10649,6931,3718,24214,92129,550323,235000,"48.99"
"Franklin",2003,10480,6790,3690,22843,76263,453680,195131,"68.15"
"Franklin",2002,10161,6554,3607,21636,65985,397146,171315,"63.32"
"Franklin",2001,11197,7569,3628,20860,57824,350372,152064,"52.71"
"Gadsden",2019,46277,27769,18508,36775,45987,228342,109267,"39.11"
"Gadsden",2018,47828,29226,18602,36571,44937,222360,107057,"73.16"
"Gadsden",2017,48263,29552,18711,35395,42600,209770,102575,"51.33"
"Gadsden",2016,48486,29849,18637,33748,40558,197449,97462,"56.13"
"Gadsden",2015,48315,30002,18313,33367,37472,181920,89776,"48.4"
"Gadsden",2014,48096,29878,18218,33021,34669,167167,82372,"63.31"
"Gadsden",2013,47588,29474,18114,31989,31968,153102,75867,"64.3"
"Gadsden",2012,47506,29595,17911,32196,29755,142006,70715,"47.95"
"Gadsden",2011,48200,29645,18555,31964,29562,141091,70421,"36.66"
"Gadsden",2010,46389,27945,18444,30919,31663,150959,75560,"44.81"
"Gadsden",2009,50046,33516,16530,31227,34730,166139,82995,"51.77"
"Gadsden",2008,50611,33544,17067,30676,41578,196841,99115,"61.62"
"Gadsden",2007,49398,32345,17053,30176,49295,234157,118017,"37.26"
"Gadsden",2006,48195,31222,16973,28655,51477,246024,123983,"42.18"
"Gadsden",2005,47713,30725,16988,27407,45378,219989,110339,"68.19"
"Gadsden",2004,46857,30185,16672,26457,37258,181323,91360,"54.84"
"Gadsden",2003,46491,29535,16956,25771,32203,156046,80015,"52.75"
"Gadsden",2002,45911,29948,15963,25380,29163,142230,73736,"55.27"
"Gadsden",2001,45284,29141,16143,23909,27038,132142,69460,"53.35"
"Gadsden",2020,46226,27380,18846,38354,48384,237603,115883,"60.04"
"Gilchrist",2020,18269,15104,3165,41772,95191,278125,179166,"58.4"
"Gilchrist",2019,17766,14867,2899,34778,92142,267779,174032,"58.04"
"Gilchrist",2018,17424,14539,2885,33200,89483,260710,169141,"74.56"
"Gilchrist",2017,17224,14403,2821,33378,83300,245573,158781,"60.15"
"Gilchrist",2016,16848,14023,2825,33264,77847,230191,148595,"55.14"
"Gilchrist",2015,16839,13906,2933,32273,71266,212438,136997,"56.16"
"Gilchrist",2014,16853,14071,2782,31880,65541,194797,125351,"64.1"
"Gilchrist",2013,16880,14213,2667,31088,59106,177648,114359,"58.45"
"Gilchrist",2012,16946,14289,2657,30018,53679,161465,104423,"63.39"
"Gilchrist",2011,16983,14288,2695,29733,53312,161255,103786,"43.8"
"Gilchrist",2010,16939,14206,2733,29997,56409,172116,110131,"50.26"
"Gilchrist",2009,17393,14929,2464,30232,60125,186464,119252,"54.04"
"Gilchrist",2008,17256,14718,2538,29905,66039,214663,134503,"45.69"
"Gilchrist",2007,17106,14614,2492,27821,76534,251079,158158,"38.52"
"Gilchrist",2006,16703,14220,2483,27359,78323,260269,163804,"37.96"
"Gilchrist",2005,16221,13786,2435,26692,67681,229107,143074,"57.06"
"Gilchrist",2004,15900,13511,2389,26260,54311,186645,116527,"64.08"
"Gilchrist",2003,15517,13214,2303,24512,46674,161372,100603,"53.17"
"Gilchrist",2002,15023,12734,2289,23400,42219,148048,91690,"55.35"
"Gilchrist",2001,14699,12425,2274,23345,38180,137066,84185,"45.41"
"Glades",2020,13609,11831,1778,46277,73685,243350,136068,"51.95"
"Glades",2019,13121,11362,1759,43901,70557,235349,130889,"52.1"
"Glades",2018,13002,11262,1740,42009,67617,226258,125657,"45.35"
"Glades",2017,13087,11340,1747,41206,64290,214596,118881,"52.69"
"Glades",2016,13047,11375,1672,39552,60896,204330,112462,"57.17"
"Glades",2015,12853,11205,1648,38755,57617,194639,107141,"51.47"
"Glades",2014,12852,11187,1665,37067,53358,182749,100585,"51.63"
"Glades",2013,12658,10967,1691,35764,48988,168571,92620,"53.71"
"Glades",2012,12671,11005,1666,35408,45261,156662,86064,"50.7"
"Glades",2011,12812,11175,1637,37164,44873,156524,85785,"46.06"
"Glades",2010,12884,11204,1680,36194,47657,167523,91479,"50.23"
"Glades",2009,11311,9656,1655,36137,51432,182275,99014,"48.16"
"Glades",2008,11323,9668,1655,34245,60766,214555,116729,"58.01"
"Glades",2007,11055,9419,1636,32780,71985,255020,138237,"37.36"
"Glades",2006,10796,9170,1626,31221,73254,262380,141652,"39.34"
"Glades",2005,10729,9074,1655,28835,62727,229116,121835,"55.82"
"Glades",2004,10733,9083,1650,24976,50030,183575,96986,"50.67"
"Glades",2003,10729,9053,1676,23208,42355,157077,83496,"49.52"
"Glades",2002,10664,9001,1663,22633,37853,143554,75891,"56"
"Glades",2001,10612,8952,1660,24048,34130,132785,68927,"54.28"
"Gulf",2020,14724,8991,5733,42426,97029,480464,217447,"53.54"
"Gulf",2019,13082,7652,5430,39193,93142,461016,208579,"48.12"
"Gulf",2018,16499,10747,5752,36906,90589,447906,203035,"65.6"
"Gulf",2017,16297,10690,5607,35146,85229,420223,190897,"56.32"
"Gulf",2016,16628,10956,5672,34341,79778,392459,178299,"56.16"
"Gulf",2015,16346,10695,5651,34912,75313,370982,168498,"55.72"
"Gulf",2014,16543,10888,5655,34181,71228,350702,159318,"64.4"
"Gulf",2013,16106,10623,5483,33292,66673,332256,149603,"68.21"
"Gulf",2012,15907,10458,5449,33159,61682,310051,138386,"55.06"
"Gulf",2011,15789,10360,5429,32590,60797,309916,136790,"42.27"
"Gulf",2010,15863,10437,5426,32220,64508,333429,145286,"50.56"
"Gulf",2009,16798,11322,5476,32092,69789,366467,157751,"65.43"
"Gulf",2008,16923,11444,5479,32145,82979,438701,187620,"51.61"
"Gulf",2007,16815,11286,5529,30835,99077,525396,224020,"38.53"
"Gulf",2006,16509,10769,5740,29949,103226,548183,233136,"45.97"
"Gulf",2005,16479,11044,5435,28999,88338,476112,199731,"59.21"
"Gulf",2004,16171,10782,5389,27664,68623,371995,155427,"50.72"
"Gulf",2003,15615,10257,5358,26188,56066,304495,127856,"70.24"
"Gulf",2002,15202,9829,5373,25737,49186,268740,112533,"62.18"
"Gulf",2001,14952,9595,5357,25735,41788,236790,96365,"50.4"
"Hamilton",2020,14570,10235,4335,50848,48330,181336,99904,"62.12"
"Hamilton",2019,14600,10054,4546,44614,46121,174027,96153,"40.31"
"Hamilton",2018,14621,10158,4463,45410,44345,165653,92377,"64.79"
"Hamilton",2017,14663,9983,4680,42886,43359,159279,89450,"49.89"
"Hamilton",2016,14665,9963,4702,38215,41532,154111,84156,"47.61"
"Hamilton",2015,14630,9913,4717,39651,35973,137976,75314,"51.6"
"Hamilton",2014,14351,9645,4706,41824,32307,124414,67218,"69.17"
"Hamilton",2013,14507,9863,4644,40587,29615,113484,61141,"58.29"
"Hamilton",2012,14836,10190,4646,40287,27015,103359,55619,"60.44"
"Hamilton",2011,14744,10208,4536,39119,26840,102860,55117,"45.89"
"Hamilton",2010,14799,8598,6201,39128,28268,109213,57824,"47.1"
"Hamilton",2009,14783,11504,3279,41653,30173,117954,63586,"52.09"
"Hamilton",2008,14779,11494,3285,36688,36172,141139,74908,"48.99"
"Hamilton",2007,14705,11436,3269,35608,41983,166847,87940,"40.22"
"Hamilton",2006,14517,11233,3284,36516,43262,173554,91396,"39.9"
"Hamilton",2005,14315,10975,3340,35951,37219,151916,79599,"57.81"
"Hamilton",2004,14303,10988,3315,34585,29575,121914,64574,"61.23"
"Hamilton",2003,14025,10635,3390,31990,24104,103400,54911,"60.38"
"Hamilton",2002,13925,10515,3410,30331,21456,93735,49478,"48.8"
"Hamilton",2001,13731,10328,3403,31378,19158,87132,44681,"42.72"
"Hardee",2020,27443,17500,9943,37761,62471,245240,123034,"51.2"
"Hardee",2019,27385,17455,9930,35948,60498,239002,119012,"51.58"
"Hardee",2018,27296,17498,9798,34934,58881,232092,115826,"55.85"
"Hardee",2017,27426,17566,9860,34226,55591,218631,109193,"59.92"
"Hardee",2016,27637,17803,9834,33283,52415,203507,103043,"55.32"
"Hardee",2015,27645,17947,9698,31846,47837,187241,94433,"58.37"
"Hardee",2014,27712,17899,9813,30806,43307,171081,86359,"56.38"
"Hardee",2013,27682,17941,9741,29632,38917,153769,77412,"54.47"
"Hardee",2012,27762,17950,9812,29821,35921,141897,71729,"51.6"
"Hardee",2011,27653,17964,9689,28940,36075,142661,72447,"48.85"
"Hardee",2010,27731,17973,9758,27770,37035,149661,74595,"53.86"
"Hardee",2009,28333,18996,9337,28118,39189,160840,79367,"52.14"
"Hardee",2008,27909,18620,9289,28463,45914,187884,93300,"49.63"
"Hardee",2007,27520,18383,9137,27305,53675,221482,109202,"39.48"
"Hardee",2006,27186,18097,9089,26632,54988,229402,112300,"42.19"
"Hardee",2005,27333,18626,8707,26413,47691,202005,98132,"58.92"
"Hardee",2004,27787,18648,9139,25940,38778,165297,80486,"57.55"
"Hardee",2003,27400,18419,8981,24761,32748,142479,69609,"58.46"
"Hardee",2002,27437,18444,8993,24389,29874,132285,64447,"60.87"
"Hardee",2001,26921,18015,8906,23461,26877,121738,59268,"53.85"
"Hendry",2020,40953,27781,13172,42744,82044,234937,140743,"51.65"
"Hendry",2019,40120,27040,13080,39935,78072,225105,134123,"54.75"
"Hendry",2018,39586,26618,12968,40841,72231,212394,124771,"43.25"
"Hendry",2017,39057,26447,12610,37041,66215,197818,115275,"53.87"
"Hendry",2016,38370,26046,12324,37102,62215,187293,109007,"55.03"
"Hendry",2015,38096,25863,12233,37523,59091,176635,104592,"54.15"
"Hendry",2014,37895,25767,12128,35585,54613,163991,96884,"49.59"
"Hendry",2013,37808,25888,11920,35353,50393,150899,89439,"49.38"
"Hendry",2012,38132,26288,11844,34784,47069,140595,83538,"44.08"
"Hendry",2011,38908,27119,11789,31929,47444,142486,84591,"47.38"
"Hendry",2010,39140,27345,11795,32946,51254,154807,92035,"51.48"
"Hendry",2009,41320,29733,11587,29098,56417,170442,101383,"51.27"
"Hendry",2008,41216,29765,11451,29950,66681,202644,120449,"58.04"
"Hendry",2007,39651,28414,11237,30891,79086,240848,143005,"39.64"
"Hendry",2006,38678,27534,11144,28556,80945,247486,146563,"38.45"
"Hendry",2005,38376,27208,11168,26882,69013,213687,125125,"59.74"
"Hendry",2004,37394,26297,11097,26487,55447,171946,101018,"49.78"
"Hendry",2003,36511,25600,10911,24916,47705,146586,87253,"50.41"
"Hendry",2002,36154,25368,10786,24133,43339,133758,79687,"56.73"
"Hendry",2001,36302,25542,10760,23189,39250,122152,72458,"56.86"
"Hernando",2020,192186,183194,8992,40932,145422,270391,196158,"49.22"
"Hernando",2019,188358,179688,8670,38093,132500,250378,180285,"57.27"
"Hernando",2018,185604,177185,8419,37411,121423,234188,166839,"63.12"
"Hernando",2017,181882,173799,8083,35749,107304,213217,150539,"50.72"
"Hernando",2016,179503,171492,8011,34330,93665,194152,135148,"50.63"
"Hernando",2015,176819,169034,7785,33813,82952,176895,121423,"51.81"
"Hernando",2014,174955,167263,7692,33127,76001,165824,111859,"64.21"
"Hernando",2013,173808,166160,7648,32141,68607,154111,101017,"50.86"
"Hernando",2012,173104,165397,7707,31953,63997,146233,94124,"59.86"
"Hernando",2011,173078,165355,7723,31149,66870,153083,97759,"49.15"
"Hernando",2010,172778,165047,7731,30767,77448,175394,112226,"44.85"
"Hernando",2009,165048,157408,7640,30751,89614,197722,127148,"49.08"
"Hernando",2008,164907,157260,7647,30133,113301,244175,158493,"44.56"
"Hernando",2007,162193,154876,7317,29328,139375,298958,196041,"45.85"
"Hernando",2006,157006,149676,7330,28990,147088,314319,208616,"41.94"
"Hernando",2005,150784,143497,7287,28325,122874,270932,177148,"53.93"
"Hernando",2004,145207,137920,7287,27081,95186,216290,138554,"59.68"
"Hernando",2003,140670,133365,7305,26442,82778,188909,120619,"65.98"
"Hernando",2002,136484,129212,7272,25349,76599,175712,111022,"62.06"
"Hernando",2001,132762,125523,7239,24973,71620,165315,104183,"49.84"
"Highlands",2020,104834,79585,25249,37952,97807,235696,151004,"49.12"
"Highlands",2019,103434,78463,24971,35661,90420,222503,142119,"49.56"
"Highlands",2018,102525,77619,24906,34535,83646,209331,133343,"53.6"
"Highlands",2017,102138,77548,24590,33819,75874,196745,123225,"55.74"
"Highlands",2016,101531,77007,24524,32840,67419,182619,111138,"57.73"
"Highlands",2015,100748,76662,24086,32515,60931,171014,101792,"57.12"
"Highlands",2014,99818,77264,22554,31284,56092,159952,93088,"56.3"
"Highlands",2013,99092,77026,22066,30831,52096,150447,87004,"57.03"
"Highlands",2012,98955,77041,21914,29618,52477,150847,87398,"51.76"
"Highlands",2011,98712,77132,21580,29287,56630,163066,94728,"42.75"
"Highlands",2010,98786,77236,21550,29786,62447,180854,103839,"50.97"
"Highlands",2009,99713,78851,20862,28651,69526,199660,116737,"42.31"
"Highlands",2008,100207,79150,21057,27692,77747,220753,142365,"51.91"
"Highlands",2007,98727,77642,21085,28315,90815,258634,166917,"38.19"
"Highlands",2006,96672,75900,20772,27538,89387,257917,168929,"39.27"
"Highlands",2005,93456,72793,20663,25795,67698,204503,130068,"57.44"
"Highlands",2004,92057,71531,20526,24487,52492,160196,99779,"58.05"
"Highlands",2003,90393,70258,20135,23299,45678,138174,86586,"53.56"
"Highlands",2002,89038,69011,20027,23210,42846,129239,81673,"62.54"
"Highlands",2001,88212,68288,19924,22852,40425,121454,77117,"54.21"
"Hillsborough",2019,1444870,988250,456620,56407,169725,376264,247272,"61.31"
"Hillsborough",2018,1408864,964883,443981,54564,160880,363192,236887,"61.8"
"Hillsborough",2017,1379302,941536,437766,52651,146879,342102,220795,"51.97"
"Hillsborough",2016,1352797,924013,428784,51197,132127,318934,202895,"56.94"
"Hillsborough",2015,1325563,905007,420556,49914,119723,298035,186700,"57.41"
"Hillsborough",2014,1301887,887882,414005,48388,111059,284034,175611,"58.91"
"Hillsborough",2013,1276410,869181,407229,47408,99170,263306,159735,"53.38"
"Hillsborough",2012,1256118,854465,401653,46893,86651,235716,140864,"55.39"
"Hillsborough",2011,1238951,842395,396556,46078,86940,235119,141518,"53.81"
"Hillsborough",2010,1229226,834255,394971,45133,98929,256979,158199,"47.69"
"Hillsborough",2009,1196892,800116,396776,44722,110783,276440,172738,"57.09"
"Hillsborough",2008,1200541,803794,396747,43298,141847,337068,216326,"46.69"
"Hillsborough",2007,1192861,799294,393567,41756,169458,404269,261395,"41.57"
"Hillsborough",2006,1164425,777670,386755,40397,168680,411779,262387,"45.02"
"Hillsborough",2005,1131546,750599,380947,38450,136586,340917,214419,"52.64"
"Hillsborough",2004,1108435,730821,377614,37448,112500,282883,179140,"65.11"
"Hillsborough",2003,1079587,707626,371961,35777,98988,250146,158587,"61.49"
"Hillsborough",2002,1055617,690391,365226,33936,89970,230167,144663,"61.95"
"Hillsborough",2001,1026906,666536,360370,32874,82755,213081,133856,"53.13"
"Hillsborough",2020,1478759,1019128,459631,60937,180656,394578,260960,"54.4"
"Holmes",2020,20001,15847,4154,33786,65990,205559,113748,"53.33"
"Holmes",2019,20049,15753,4296,32762,64129,194319,109341,"47.82"
"Holmes",2018,20133,16044,4089,31553,61241,187505,105501,"76.26"
"Holmes",2017,20210,16110,4100,31061,55914,175432,98282,"61.29"
"Holmes",2016,20003,15916,4087,29309,50598,162783,89899,"58.86"
"Holmes",2015,19902,15834,4068,29774,45775,149792,81849,"68.44"
"Holmes",2014,20025,15935,4090,29068,41014,137448,74113,"65.18"
"Holmes",2013,20022,15913,4109,27963,36952,125191,67265,"79.13"
"Holmes",2012,19984,15868,4116,27700,33731,115261,61519,"59.01"
"Holmes",2011,19901,15694,4207,27108,33278,114758,60973,"43.85"
"Holmes",2010,19927,15672,4255,26951,35490,121485,64501,"46.35"
"Holmes",2009,19857,15748,4109,27228,38576,133935,70334,"78.55"
"Holmes",2008,19757,15633,4124,26701,44486,156766,82070,"58.8"
"Holmes",2007,19464,15358,4106,26722,52078,185186,96393,"50.39"
"Holmes",2006,19502,15475,4027,25643,53584,192909,99549,"43.11"
"Holmes",2005,19157,15114,4043,24946,47260,172893,88421,"60.22"
"Holmes",2004,19012,15035,3977,24428,39004,144633,73974,"63.84"
"Holmes",2003,18940,14966,3974,23261,34680,127268,66103,"67.01"
"Holmes",2002,18708,14646,4062,22566,31613,116088,60652,"62.96"
"Holmes",2001,18714,14680,4034,22259,27702,102361,54988,"50.2"
"Indian",2020,158834,105833,53001,47130,159524,480687,248283,"71.71"
"Indian",2019,154939,102713,52226,43902,152056,463058,237197,"52.03"
"Indian",2018,151825,100719,51106,42879,146163,453979,230917,"43.48"
"Indian",2017,148962,98644,50318,41571,134055,426998,214954,"58.1"
"Indian",2016,146410,96993,49417,40903,120810,401127,197812,"61.53"
"Indian",2015,143326,94820,48506,40170,107503,370242,180037,"49.83"
"Indian",2014,140955,93155,47800,38754,97731,343493,164635,"51.32"
"Indian",2013,139586,92382,47204,37075,89451,321164,151720,"45.24"
"Indian",2012,139446,92378,47068,37121,79629,293748,135698,"46.97"
"Indian",2011,138694,91899,46795,35320,81276,299708,139144,"51.87"
"Indian",2010,138028,91363,46665,35191,91302,331029,154422,"40.18"
"Indian",2009,141634,91606,50028,35937,99138,351260,163866,"40.12"
"Indian",2008,141667,91612,50055,36557,124279,420920,199154,"58.83"
"Indian",2007,139757,90607,49150,35901,154677,510303,245940,"45.36"
"Indian",2006,135262,86779,48483,33823,171392,562933,274946,"36.26"
"Indian",2005,130043,83822,46221,32591,145657,494924,235382,"58.27"
"Indian",2004,126829,81217,45612,31812,112140,391998,182798,"57.98"
"Indian",2003,121174,76908,44266,29546,95943,336743,156201,"52.96"
"Indian",2002,118149,75039,43110,28444,86976,306841,141095,"57.93"
"Indian",2001,115716,73458,42258,27900,79969,280706,129902,"51.99"
"Jackson",2019,46969,31267,15702,36652,56139,201847,107864,"43.59"
"Jackson",2018,50435,32903,17532,35620,54925,197463,105216,"72.75"
"Jackson",2017,50418,32764,17654,34473,52097,187435,99742,"54.65"
"Jackson",2016,50345,32702,17643,33911,48572,174823,93212,"56.72"
"Jackson",2015,50458,32703,17755,33499,44203,159517,85642,"58.24"
"Jackson",2014,50231,32258,17973,32773,39890,144935,77428,"61.29"
"Jackson",2013,50166,32082,18084,32151,36339,132367,70572,"67.27"
"Jackson",2012,49847,32138,17709,31776,33507,121986,65312,"51.75"
"Jackson",2011,49964,33974,15990,31570,33633,121834,65377,"38.68"
"Jackson",2010,49746,33828,15918,31065,35868,129708,69938,"43.59"
"Jackson",2009,52637,34086,18551,31045,39300,142552,77171,"62.84"
"Jackson",2008,52639,33973,18666,29839,46026,167868,90779,"63.11"
"Jackson",2007,50416,33360,17056,29338,54035,198784,107085,"36.99"
"Jackson",2006,50246,33191,17055,28114,56074,207558,111809,"41.05"
"Jackson",2005,49691,32757,16934,27760,49228,184217,99090,"61.05"
"Jackson",2004,48870,32275,16595,25836,40502,151434,82222,"53.2"
"Jackson",2003,48991,32613,16378,26333,35524,131872,72812,"54.58"
"Jackson",2002,47707,31528,16179,24050,32993,121993,68320,"70.14"
"Jackson",2001,47495,31346,16149,23964,30066,112399,63403,"49.53"
"Jackson",2020,46587,31199,15388,38877,58378,206965,110893,"64.5"
"Jefferson",2020,14394,11957,2437,35762,84155,329761,172632,"67.58"
"Jefferson",2019,14776,12327,2449,34984,82138,321549,170769,"40.18"
"Jefferson",2018,14733,12321,2412,33905,78120,303328,163111,"74.03"
"Jefferson",2017,14611,12186,2425,33246,73574,289141,154652,"49.93"
"Jefferson",2016,14498,12055,2443,33280,68270,266335,142717,"59.78"
"Jefferson",2015,14519,12061,2458,32223,61437,239326,127576,"47.77"
"Jefferson",2014,14597,12116,2481,31216,53913,214658,113587,"65.83"
"Jefferson",2013,14554,12086,2468,30576,48460,194757,103251,"66.14"
"Jefferson",2012,14478,12034,2444,29741,43019,176632,93266,"56.1"
"Jefferson",2011,14666,12210,2456,28395,40802,171933,89829,"39.6"
"Jefferson",2010,14761,12255,2506,28646,41967,178796,93269,"50.5"
"Jefferson",2009,14677,12156,2521,29679,45403,192537,100997,"52.98"
"Jefferson",2008,14553,12016,2537,28867,54436,230446,120545,"52.77"
"Jefferson",2007,14494,11940,2554,29110,63910,272518,142161,"36.49"
"Jefferson",2006,14353,11833,2520,28136,65442,282748,147387,"39.51"
"Jefferson",2005,14233,11679,2554,26767,57681,251042,130423,"63.11"
"Jefferson",2004,14064,11527,2537,25698,45976,203015,104971,"57.35"
"Jefferson",2003,13552,11019,2533,24291,39892,176741,90916,"64.78"
"Jefferson",2002,13261,10716,2545,23414,35351,159786,81653,"51.58"
"Jefferson",2001,13043,10517,2526,22623,30812,140812,72849,"48.4"
"Lafayette",2020,8690,7473,1217,35940,71253,230940,139490,"54.45"
"Lafayette",2019,8482,7265,1217,33309,67485,222833,131191,"52.32"
"Lafayette",2018,8501,7293,1208,33359,65148,215325,126741,"75.41"
"Lafayette",2017,8479,7253,1226,31804,60585,203457,117715,"57.11"
"Lafayette",2016,8621,7420,1201,31049,55537,186743,107857,"56.1"
"Lafayette",2015,8664,7463,1201,29526,49788,173288,98405,"51.39"
"Lafayette",2014,8696,7497,1199,29619,43587,158662,85604,"70.56"
"Lafayette",2013,8618,7402,1216,28856,39153,146112,78739,"59.49"
"Lafayette",2012,8663,7441,1222,28781,33520,131047,68998,"68.84"
"Lafayette",2011,8752,7527,1225,27687,32640,128253,67935,"45.09"
"Lafayette",2010,8870,7633,1237,28134,34690,139258,72931,"51.67"
"Lafayette",2009,8183,7185,998,28135,37166,158232,81236,"54.16"
"Lafayette",2008,8287,7278,1009,27333,45892,181925,101016,"52.24"
"Lafayette",2007,8215,7202,1013,26768,52682,210435,117416,"41.26"
"Lafayette",2006,8060,7035,1025,25729,53671,219559,121723,"40.99"
"Lafayette",2005,7971,6955,1016,24478,46191,191316,106568,"59.59"
"Lafayette",2004,7535,6513,1022,24481,37516,156675,88175,"62.22"
"Lafayette",2003,7353,6341,1012,23591,32137,135026,77040,"59.54"
"Lafayette",2002,7205,6195,1010,21330,29129,121198,70170,"54.35"
"Lafayette",2001,7057,6056,1001,21192,26981,113588,65247,"42.4"
"Lake",2020,366742,167901,198841,42016,170192,344883,245630,"53.48"
"Lake",2019,357247,165760,191487,39064,158739,326774,231668,"51.09"
"Lake",2018,342917,159945,182972,38237,148989,312115,219648,"56.87"
"Lake",2017,331724,158877,172847,36597,137155,293966,203746,"57.25"
"Lake",2016,323985,159296,164689,36000,125510,276163,188816,"46.6"
"Lake",2015,316569,160400,156169,35531,115684,259557,175998,"47.46"
"Lake",2014,309736,157950,151786,34204,108708,248208,166925,"54.86"
"Lake",2013,303317,155998,147319,33393,98655,228355,151927,"48.59"
"Lake",2012,299677,154655,145022,32720,89373,210594,137279,"46.38"
"Lake",2011,298265,154387,143878,32373,91473,212832,138682,"47.87"
"Lake",2010,297047,154245,142802,32219,102674,237244,153634,"45.23"
"Lake",2009,291993,158729,133264,31876,115703,263459,170524,"49.7"
"Lake",2008,288379,157380,130999,32369,145385,328802,214442,"50.83"
"Lake",2007,286499,156327,130172,31682,169787,386098,253987,"42.41"
"Lake",2006,276783,151734,125049,32269,171725,395617,260646,"38.04"
"Lake",2005,263017,146221,116796,30872,140195,329426,213535,"58.55"
"Lake",2004,251878,141203,110675,28996,110920,259699,169596,"53.67"
"Lake",2003,240716,135518,105198,27702,99925,233311,152747,"55.71"
"Lake",2002,231072,131010,100062,26632,94095,221294,143782,"66.47"
"Lake",2001,220323,126253,94070,25917,89287,211430,136424,"51.14"
"Lee",2020,750493,368415,382078,49795,170022,451023,264492,"48.33"
"Lee",2019,735148,361315,373833,46190,164258,438653,255397,"59.03"
"Lee",2018,713903,355737,358166,44827,160874,434970,252039,"51.96"
"Lee",2017,698468,350230,348238,43501,153871,425580,243484,"63.5"
"Lee",2016,680539,342137,338402,41884,145525,415738,233284,"58.72"
"Lee",2015,665845,337490,328355,40921,130637,386918,212118,"56.73"
"Lee",2014,653485,361890,291595,39616,116442,355103,190462,"49.44"
"Lee",2013,643367,357168,286199,38883,103908,327458,171335,"52.51"
"Lee",2010,618754,345548,273206,37602,87444,301960,146116,"48.39"
"Lee",2009,615124,323780,291344,37641,98755,333128,163849,"45.05"
"Lee",2008,623725,329279,294446,37866,138893,422511,225660,"51.7"
"Lee",2007,615741,324885,290856,37658,188852,548500,305385,"36.39"
"Lee",2006,585608,308667,276941,37065,211948,615275,347379,"45.12"
"Lee",2005,549442,292414,257028,35649,167753,506833,278765,"66.93"
"Lee",2004,521253,276939,244314,33932,131845,405748,218318,"52.04"
"Lee",2003,495088,269200,225888,31523,115723,357459,191978,"61.46"
"Lee",2002,475073,258467,216606,30324,102234,317331,170265,"51.45"
"Lee",2001,454918,247287,207631,29432,92478,285461,153596,"48.54"
"Lee",2012,638029,353196,284833,38628,90988,298576,150153,"45.63"
"Lee",2011,625310,348297,277013,38192,85253,289877,141450,"49.34"
"Leon",2020,299484,100857,198627,49865,113710,331396,204846,"55.89"
"Leon",2019,296499,100786,195713,46524,107787,318156,195087,"38.61"
"Leon",2018,292332,99951,192381,45272,103163,309742,188269,"74.17"
"Leon",2017,287899,98274,189625,44297,96437,295004,177640,"51.02"
"Leon",2016,287671,97996,189675,42887,90396,278805,167206,"58.5"
"Leon",2015,284443,96447,187996,42217,87280,269697,160779,"49.97"
"Leon",2014,281292,95508,185784,41113,85963,264273,158105,"66.21"
"Leon",2013,278377,94650,183727,40253,83648,257285,153588,"66.55"
"Leon",2012,277670,94027,183643,40087,82052,248305,148251,"53.5"
"Leon",2011,276278,93796,182482,39677,87024,258002,155241,"36.4"
"Leon",2010,275487,94111,181376,39561,97440,283172,170634,"50.28"
"Leon",2009,274803,96924,177879,39145,102722,296806,178654,"54.16"
"Leon",2008,274892,97040,177852,38517,114325,330238,197690,"56.9"
"Leon",2007,272896,96467,176429,37585,124463,359902,214867,"39.94"
"Leon",2006,272497,96161,176336,36033,121973,355501,212076,"43.81"
"Leon",2005,271111,96330,174781,34541,107181,314505,187362,"64.85"
"Leon",2004,263896,94760,169136,33578,92760,272755,162871,"54.69"
"Leon",2003,255500,93190,162310,32069,82254,241794,144834,"58.24"
"Leon",2002,248039,91336,156703,31432,74792,220145,131783,"54.7"
"Leon",2001,244208,90550,153658,30287,70366,207335,123704,"55.82"
"Levy",2020,41699,32220,9479,35568,76519,246958,143863,"56.6"
"Levy",2019,41330,31881,9449,33640,73488,238131,138428,"58.54"
"Levy",2018,41054,31621,9433,32670,69978,229415,132701,"71.86"
"Levy",2017,41015,31558,9457,31512,67519,220073,127813,"56.3"
"Levy",2016,40553,31255,9298,30912,65013,210186,122366,"50.34"
"Levy",2015,40448,31199,9249,30101,61340,199656,115071,"54.54"
"Levy",2014,40473,31301,9172,29272,56509,185381,106642,"60.13"
"Levy",2013,40304,31053,9251,28875,52174,171291,98095,"55.23"
"Levy",2012,40339,31080,9259,28491,48199,159196,90417,"60.15"
"Levy",2011,40767,31499,9268,27900,48589,159858,91112,"41.28"
"Levy",2010,40801,31526,9275,27598,51511,169736,96303,"49.06"
"Levy",2009,40674,30730,9944,27281,56101,186175,104660,"51.67"
"Levy",2008,40817,30650,10167,27627,65545,219895,122896,"40.15"
"Levy",2007,40045,29846,10199,26818,77673,262551,146032,"43.04"
"Levy",2006,38981,29142,9839,26122,81624,290478,155126,"39.26"
"Levy",2005,37985,28295,9690,24975,65956,253675,126640,"58.26"
"Levy",2004,37486,28263,9223,24502,52135,229223,107406,"64.81"
"Levy",2003,36664,27595,9069,22817,43686,195212,93131,"53.05"
"Levy",2002,36013,27023,8990,21438,39587,178057,85311,"56.95"
"Levy",2001,35118,26317,8801,21665,36135,163205,78798,"49.32"
"Liberty",2020,8575,7663,912,40072,50692,204421,115010,"48.86"
"Liberty",2019,8772,7832,940,38746,48932,201160,112503,"45.2"
"Liberty",2018,8915,7965,950,39206,45928,191762,105908,"69.73"
"Liberty",2017,8719,7765,954,36395,42223,176702,98092,"56.35"
"Liberty",2016,8736,7819,917,34507,39148,164883,89930,"56.46"
"Liberty",2015,8698,7740,958,34427,35492,146984,79628,"53.78"
"Liberty",2014,8668,7710,958,33566,32069,138094,73227,"65.12"
"Liberty",2013,8483,7489,994,32127,29719,128663,67702,"65.67"
"Liberty",2012,8519,7524,995,30322,26732,116734,62054,"51.81"
"Liberty",2011,8370,7370,1000,31181,26285,113817,61193,"38.6"
"Liberty",2010,8365,7369,996,33999,27782,118569,64273,"49.27"
"Liberty",2009,8220,7230,990,35193,28560,122222,67662,"62.14"
"Liberty",2008,8158,7207,951,34318,34881,150797,82165,"56.39"
"Liberty",2007,7772,6822,950,33801,41730,180240,101078,"38.54"
"Liberty",2006,7772,6815,957,32067,NULL,NULL,NULL,"44.97"
"Liberty",2005,7581,6639,942,30473,NULL,NULL,NULL,"64.42"
"Liberty",2004,7354,6412,942,28041,NULL,NULL,NULL,"53.06"
"Liberty",2003,7227,6295,932,27497,NULL,NULL,NULL,"62.18"
"Liberty",2002,7157,6169,988,26848,NULL,NULL,NULL,"60.9"
"Liberty",2001,7132,6203,929,27255,NULL,NULL,NULL,"52.51"
"Madison",2020,18954,14964,3990,35194,52273,219025,110082,"52.32"
"Madison",2019,19570,15443,4127,33283,50223,213841,107707,"43.04"
"Madison",2018,19473,15257,4216,32979,49107,212052,105549,"72.26"
"Madison",2017,19377,15249,4128,32067,46240,198287,99675,"50.55"
"Madison",2016,19238,15073,4165,31774,42630,180887,90315,"53.48"
"Madison",2015,19200,15041,4159,32062,37653,163030,80572,"50.72"
"Madison",2014,19303,15107,4196,31479,33145,144728,71584,"67.65"
"Madison",2013,19395,15144,4251,29842,30209,132099,65455,"63.33"
"Madison",2010,19224,14980,4244,29119,29561,129103,63529,"49.57"
"Madison",2009,20333,15870,4463,28715,32127,141992,68864,"52.48"
"Madison",2008,20152,15814,4338,28039,37150,166218,80215,"53.54"
"Madison",2007,19944,15632,4312,27233,43164,196055,93643,"36.74"
"Madison",2006,19814,15476,4338,26033,44660,205174,97601,"37.71"
"Madison",2005,19696,15350,4346,24611,38908,181999,85572,"61.66"
"Madison",2004,19498,15169,4329,24014,31712,150644,70676,"61.39"
"Madison",2003,19139,14825,4314,22370,26188,128713,59835,"64.05"
"Madison",2002,18932,14657,4275,21403,23895,119416,54958,"47.77"
"Madison",2001,18862,14560,4302,20837,22601,112761,52812,"41.95"
"Madison",2012,19227,15005,4222,29605,27452,121255,59870,"58.29"
"Madison",2011,19298,15050,4248,29237,27594,120939,59291,"43.6"
"Manatee",2020,398503,317022,81481,47554,187800,485009,308325,"52.32"
"Manatee",2019,387414,307843,79571,44309,180717,471077,297662,"52.9"
"Manatee",2018,377826,299207,78619,43043,175197,462847,291282,"58.12"
"Manatee",2017,368782,291864,76918,41597,167213,452713,282599,"60.8"
"Manatee",2016,357591,281668,75923,40913,156078,434925,268303,"58.52"
"Manatee",2015,349334,274792,74542,39444,142259,409934,248962,"55.93"
"Manatee",2014,339545,266699,72846,37931,129782,385734,231081,"59.79"
"Manatee",2013,333880,261682,72198,37320,115151,349889,207114,"56.39"
"Manatee",2012,330302,258211,72091,36998,103987,321049,185251,"53.58"
"Manatee",2011,325905,254556,71349,36948,102138,315146,178895,"46.67"
"Manatee",2010,322833,251773,71060,35939,114889,342709,195412,"48.72"
"Manatee",2009,318404,238835,79569,34885,126257,368781,209890,"51.92"
"Manatee",2008,317699,237929,79770,34923,159402,444957,257077,"47.25"
"Manatee",2007,315890,236109,79781,34792,199685,553606,319115,"39.41"
"Manatee",2006,308325,228622,79703,33744,213606,607151,351499,"49.31"
"Manatee",2005,304364,225722,78642,31906,177271,516607,291964,"55.27"
"Manatee",2004,295242,218616,76626,30503,142868,418963,235676,"59.33"
"Manatee",2003,286884,210813,76071,29217,123781,364177,206153,"69.03"
"Manatee",2002,277362,203605,73757,28561,110647,326456,184851,"59.48"
"Manatee",2001,270771,197350,73421,26629,100158,294064,166657,"54.91"
"Marion",2020,368135,297855,70280,41925,116199,257430,170377,"54.52"
"Marion",2019,360421,290747,69674,39544,107758,245198,160650,"50.52"
"Marion",2018,353898,285899,67999,38265,98763,231697,150330,"63.97"
"Marion",2017,349267,281812,67455,37233,89709,218024,139642,"60.84"
"Marion",2016,345749,278439,67310,37092,80339,203557,127054,"46.92"
"Marion",2015,341205,275382,65823,35784,73682,193654,118117,"50.37"
"Marion",2014,337455,272607,64848,34811,68898,183602,111208,"59.65"
"Marion",2013,335008,270338,64670,34425,64398,172419,104008,"51.44"
"Marion",2012,332989,268686,64303,33841,60681,164174,97680,"52.99"
"Marion",2011,331745,267939,63806,33475,64065,173604,102981,"48.95"
"Marion",2010,331303,267805,63498,33014,74018,195751,118386,"49.2"
"Marion",2009,330440,268855,61585,32724,84985,217941,134017,"51.86"
"Marion",2008,329418,267915,61503,32579,103048,256570,159785,"49.75"
"Marion",2007,325023,263792,61231,31623,117155,290799,182532,"50.15"
"Marion",2006,315074,256386,58688,31330,115191,288549,181630,"37.92"
"Marion",2005,304926,248768,56158,30008,89239,233263,144607,"58.52"
"Marion",2004,293317,239352,53965,29013,72561,191313,117844,"63.17"
"Marion",2003,281966,228313,53653,27840,64836,171864,105765,"54.17"
"Marion",2002,271096,218238,52858,26628,60942,162204,99228,"59.94"
"Marion",2001,264277,211582,52695,26012,59640,158926,97364,"48.44"
"Martin",2020,161301,134284,27017,47081,176405,559726,355182,"50.06"
"Martin",2019,158598,132144,26454,43626,167539,535342,338967,"59.49"
"Martin",2018,155556,129357,26199,42308,160672,521714,330500,"46.83"
"Martin",2017,153022,133852,19170,41252,150103,499275,314101,"63.85"
"Martin",2016,150870,131784,19086,40663,138903,474722,295185,"52.22"
"Martin",2015,150062,131047,19015,40420,127105,444212,274224,"43.29"
"Martin",2014,148585,129704,18881,39007,115962,414894,253807,"51.07"
"Martin",2013,148077,129133,18944,38148,104288,384017,230079,"49.67"
"Martin",2012,147203,128332,18871,39439,97358,362593,213568,"47.36"
"Martin",2011,146689,127916,18773,39324,98185,364839,215163,"45.42"
"Martin",2010,146318,127557,18761,38505,107104,388765,228925,"49.49"
"Martin",2009,143856,124191,19665,38553,117405,420174,243259,"46.01"
"Martin",2008,143868,124205,19663,37805,141213,488998,285079,"62.26"
"Martin",2007,143737,124094,19643,37341,167893,568358,329915,"51.04"
"Martin",2006,142645,122940,19705,35098,189686,639861,373760,"36.49"
"Martin",2005,141059,121516,19543,34518,164628,568867,328051,"57.74"
"Martin",2004,137637,118650,18987,32605,131271,460333,262035,"60.07"
"Martin",2003,134491,116162,18329,30963,107845,381696,217628,"54.83"
"Martin",2002,131051,113008,18043,30638,91073,327735,188295,"50.58"
"Martin",2001,128873,111056,17817,28589,80923,292131,169137,"60.52"
"Miami-Dade",2019,2812130,1212200,1599930,56621,206193,558610,353926,"53.93"
"Miami-Dade",2018,2779322,1203732,1575590,54800,198642,546685,339671,"49.61"
"Miami-Dade",2017,2743095,1191589,1551506,52961,186445,526828,316975,"58.61"
"Miami-Dade",2016,2700794,1176731,1524063,51259,171785,504108,292275,"54.14"
"Miami-Dade",2015,2653934,1160457,1493477,50527,156448,472372,265944,"56.8"
"Miami-Dade",2014,2613692,1146579,1467113,48883,143635,443120,244165,"50.03"
"Miami-Dade",2013,2582375,1137821,1444554,47458,124140,394333,213701,"60.51"
"Miami-Dade",2012,2551290,1121297,1429993,47011,106153,345554,188015,"68.47"
"Miami-Dade",2010,2496457,1109424,1387033,45653,111149,355742,198408,"56.46"
"Miami-Dade",2009,2472344,1081422,1390922,45231,130708,394497,224780,"50.95"
"Miami-Dade",2008,2477289,1088714,1388575,45142,181664,533586,315895,"53.38"
"Miami-Dade",2007,2462292,1095100,1367192,44228,220834,653713,386882,"54.23"
"Miami-Dade",2006,2437022,1098924,1338098,42975,214456,641725,376292,"46.57"
"Miami-Dade",2005,2422075,1134686,1287389,40599,175491,532778,307637,"57.32"
"Miami-Dade",2004,2379818,1098940,1280878,38849,140344,426185,244443,"45.76"
"Miami-Dade",2003,2345932,1215197,1130735,36889,119586,361807,207530,"61.45"
"Miami-Dade",2002,2312478,1223571,1088907,35694,101930,310009,177452,"54.86"
"Miami-Dade",2001,2285869,1206210,1079659,34524,89907,273026,156934,"64.01"
"Miami-Dade",2020,2832794,1220446,1612348,60927,213166,571874,367753,"73.28"
"Miami-Dade",2011,2516537,1109057,1407480,46438,101886,333509,183754,"55.93"
"Monroe",2020,77823,36477,41346,47377,409630,1233955,661531,"70.63"
"Monroe",2019,76212,35294,40918,43856,405511,1232377,657944,"49.37"
"Monroe",2018,73940,34266,39674,42722,382180,1176693,625201,"45.51"
"Monroe",2017,76889,36202,40687,41017,374408,1165700,617164,"52.65"
"Monroe",2016,76047,35315,40732,39120,365021,1148754,605650,"47.8"
"Monroe",2015,74206,33926,40280,38902,330934,1056605,552227,"51.33"
"Monroe",2014,74044,33793,40251,37614,NULL,NULL,NULL,"44.61"
"Monroe",2013,73560,33380,40180,36780,NULL,NULL,NULL,"51.73"
"Monroe",2012,72897,32776,40121,37674,NULL,NULL,NULL,"57.05"
"Monroe",2011,72670,32603,40067,38013,NULL,NULL,NULL,"52.05"
"Monroe",2010,73090,33044,40046,37630,NULL,NULL,NULL,"52.53"
"Monroe",2009,77925,36268,41657,37182,NULL,NULL,NULL,"44.25"
"Monroe",2008,76081,34788,41293,36610,NULL,NULL,NULL,"50.84"
"Monroe",2007,78987,35749,43238,36993,NULL,NULL,NULL,"48.67"
"Monroe",2006,80510,36466,44044,34930,NULL,NULL,NULL,"43.97"
"Monroe",2005,82413,37164,45249,32778,NULL,NULL,NULL,"48.07"
"Monroe",2004,81236,36606,44630,30571,NULL,NULL,NULL,"39.88"
"Monroe",2003,80537,36399,44138,28907,NULL,NULL,NULL,"55.32"
"Monroe",2002,81140,36772,44368,27634,NULL,NULL,NULL,"48.86"
"Monroe",2001,80588,36511,44077,26489,NULL,NULL,NULL,"57.3"
"Nassau",2020,89258,71301,17957,45091,224534,537842,307004,"62.98"
"Nassau",2019,85070,67804,17266,42373,211738,513382,291239,"44.82"
"Nassau",2018,82748,65692,17056,41359,196790,487082,275584,"54.15"
"Nassau",2017,80456,63661,16795,39531,179825,454522,254759,"56.01"
"Nassau",2016,77841,61462,16379,38870,166184,426216,236659,"41.96"
"Nassau",2015,76536,60349,16187,39959,159156,416831,229069,"48.63"
"Nassau",2014,75321,59212,16109,40092,150773,400751,217194,"61.3"
"Nassau",2013,74661,58632,16029,38637,132290,361153,192620,"52.07"
"Nassau",2012,73745,57997,15748,39729,120099,329775,175097,"55.02"
"Nassau",2011,73684,57954,15730,38377,120236,330436,175371,"44.93"
"Nassau",2010,73314,57618,15696,37186,128721,352642,187419,"33.18"
"Nassau",2009,72588,56400,16188,34976,140775,386199,205070,"55.57"
"Nassau",2008,71915,55865,16050,34821,167035,457885,242604,"51.21"
"Nassau",2007,69569,53520,16049,34688,181494,494528,264962,"45.09"
"Nassau",2006,68188,52064,16124,33973,173080,478530,255057,"35.05"
"Nassau",2005,65759,49944,15815,32948,148564,417547,218141,"60.92"
"Nassau",2004,65016,49481,15535,31810,127458,360811,186981,"57.13"
"Nassau",2003,63062,47930,15132,31438,116113,330288,171630,"49.68"
"Nassau",2002,61094,46372,14722,30747,107885,310995,162857,"52.29"
"Nassau",2001,59409,44577,14832,29673,98556,286319,151108,"43.12"
"Okaloosa",2020,203951,116954,86997,52265,173402,442778,249515,"54.59"
"Okaloosa",2019,201514,115579,85935,47750,157585,411284,228368,"52.64"
"Okaloosa",2018,198152,113497,84655,45655,147416,391219,216413,"72.63"
"Okaloosa",2017,195488,111495,83993,44313,136516,369247,202910,"73.38"
"Okaloosa",2016,192925,110335,82590,43388,127113,349792,191323,"56.51"
"Okaloosa",2015,191898,110280,81618,42627,122509,341090,185609,"56.55"
"Okaloosa",2014,190666,109766,80900,41111,118877,333135,181012,"64.37"
"Okaloosa",2013,188349,108531,79818,40207,113062,321059,173895,"70.44"
"Okaloosa",2012,187280,107903,79377,39523,106442,304310,165261,"58.03"
"Okaloosa",2011,181679,104982,76697,38881,107585,306884,166053,"45.59"
"Okaloosa",2010,180822,104759,76063,38638,117431,329106,177382,"54.34"
"Okaloosa",2009,196237,117119,79118,37823,124548,346692,183958,"78.2"
"Okaloosa",2008,197597,117526,80071,36454,143502,395861,207886,"55.53"
"Okaloosa",2007,196540,116299,80241,35613,163655,452289,236064,"52.86"
"Okaloosa",2006,192672,114483,78189,34409,175265,496494,257523,"39.58"
"Okaloosa",2005,188939,112354,76585,32976,146815,437950,217967,"71.84"
"Okaloosa",2004,185778,110966,74812,31163,107673,323933,160847,"69.61"
"Okaloosa",2003,181102,108157,72945,29266,91240,267588,136315,"69.49"
"Okaloosa",2002,176971,105334,71637,27242,84890,249014,127219,"65.19"
"Okaloosa",2001,173450,102818,70632,26151,82044,239843,122682,"50.19"
"Okeechobee",2020,42112,36424,5688,40640,127029,353866,219093,"69.15"
"Okeechobee",2019,41808,36205,5603,37225,120424,338333,208351,"50.97"
"Okeechobee",2018,41120,35559,5561,37077,113408,322015,197102,"47.21"
"Okeechobee",2017,41140,35574,5566,39506,104928,300195,183748,"56.41"
"Okeechobee",2016,40806,35254,5552,34642,99740,283234,174505,"57.87"
"Okeechobee",2015,40052,34518,5534,35213,95414,269155,166251,"50.69"
"Okeechobee",2014,39828,34245,5583,33987,89158,251064,155402,"52.32"
"Okeechobee",2013,39762,34212,5550,33332,82155,229936,143644,"50.79"
"Okeechobee",2012,39805,34227,5578,32167,76024,213006,132781,"49.38"
"Okeechobee",2011,39870,34289,5581,31449,76390,214295,133229,"46.21"
"Okeechobee",2010,39996,34375,5621,31177,81617,229264,142177,"46.46"
"Okeechobee",2009,39703,34326,5377,30904,90582,255002,157725,"42.69"
"Okeechobee",2008,40003,34507,5496,30311,107098,304304,187527,"53.74"
"Okeechobee",2007,39030,33216,5814,29661,126756,361475,223019,"41.66"
"Okeechobee",2006,38666,32993,5673,28870,130384,373629,230527,"35.68"
"Okeechobee",2005,37765,32322,5443,27966,111663,323474,198065,"54.71"
"Okeechobee",2004,38004,32546,5458,27363,94226,271281,167095,"60.84"
"Okeechobee",2003,37236,31784,5452,25767,85408,244653,152287,"55.88"
"Okeechobee",2002,36551,31155,5396,25162,78134,222913,139921,"53.17"
"Okeechobee",2001,36147,30768,5379,24869,71822,205098,129513,"53.17"
"Orange",2019,1386080,876910,509170,51501,183780,402814,276264,"53.08"
"Orange",2018,1349597,855307,494290,49952,172384,385598,263184,"53.92"
"Orange",2017,1313880,834353,479527,48203,156480,361698,244122,"52.26"
"Orange",2016,1280387,813421,466966,46990,141584,339004,225442,"51.26"
"Orange",2015,1252396,799985,452411,46014,129102,317913,207096,"49.31"
"Orange",2014,1227995,786296,441699,44422,121894,306188,196501,"57.21"
"Orange",2013,1202978,772657,430321,43145,107148,278080,174216,"47.32"
"Orange",2012,1175941,754470,421471,42857,90136,238877,148050,"43.9"
"Orange",2011,1157342,742671,414671,42058,87041,232360,144762,"52.38"
"Orange",2010,1145956,736657,409299,41487,97630,254457,161561,"43.97"
"Orange",2009,1108882,710458,398424,41048,116111,283754,181940,"49.04"
"Orange",2008,1114979,715627,399352,41046,159693,374236,242318,"52.17"
"Orange",2007,1105603,713851,391752,40185,193598,456527,298328,"39.64"
"Orange",2006,1079524,697666,381858,39180,192832,465996,304461,"40.03"
"Orange",2005,1043437,677185,366252,37701,153556,378894,243150,"60.61"
"Orange",2004,1013937,662530,351407,36446,123853,304649,196428,"54.67"
"Orange",2003,983165,645092,338073,34630,110405,271928,175999,"53.04"
"Orange",2002,955865,631450,324415,33650,101629,252527,162488,"67.76"
"Orange",2001,930034,619597,310437,32218,94441,236215,150782,"51.06"
"Orange",2020,1415260,893300,521960,56606,194648,420622,290070,"61.74"
"Osceola",2020,387055,260514,126541,41442,190873,336979,254924,"50.72"
"Osceola",2019,370552,247878,122674,38799,182792,327091,245429,"53.54"
"Osceola",2018,352496,233608,118888,37721,167963,308222,228864,"52.79"
"Osceola",2017,337614,222558,115056,36852,154486,289895,211993,"53.97"
"Osceola",2016,322862,211463,111399,36232,143305,276343,197669,"54.87"
"Osceola",2015,308327,200419,107908,35863,132988,262515,184332,"54.12"
"Osceola",2014,295553,191514,104039,34970,124541,251303,174456,"57.2"
"Osceola",2013,288361,185825,102536,34138,106611,223011,150507,"49.52"
"Osceola",2012,280866,180821,100045,33803,89065,194810,127107,"43.74"
"Osceola",2011,273867,177648,96219,33036,84099,188310,121698,"51.48"
"Osceola",2010,268685,173820,94865,33079,91967,207583,133392,"44.8"
"Osceola",2009,272788,178908,93880,32476,109377,241971,155841,"46.66"
"Osceola",2008,273709,179424,94285,32161,164158,347801,230798,"56.51"
"Osceola",2007,266123,174453,91670,31958,201979,426398,285278,"40.17"
"Osceola",2006,255903,165627,90276,30505,205219,442629,294645,"38.91"
"Osceola",2005,235156,152233,82923,29288,163317,363687,235780,"62.86"
"Osceola",2004,225816,145568,80248,27948,128022,286203,185248,"55.74"
"Osceola",2003,210438,134260,76178,26922,112991,252175,164332,"53"
"Osceola",2002,193355,120552,72803,26099,106052,238847,154678,"62.99"
"Osceola",2001,179534,109190,70344,25083,99830,227287,145011,"51.55"
"Palm",2019,1447857,629451,818406,56421,163849,546223,339710,"60.53"
"Palm",2018,1433417,624941,808476,54787,157857,535166,331060,"50.25"
"Palm",2017,1414144,618446,795698,53493,148543,515125,315485,"61.84"
"Palm",2016,1391741,611651,780090,51834,138433,493033,298339,"50.68"
"Palm",2015,1378417,606274,772143,51328,126982,463615,277959,"48.71"
"Palm",2014,1360238,599993,760245,49845,115835,434129,256934,"57.13"
"Palm",2013,1345652,596187,749465,48214,99609,387643,222805,"57.48"
"Palm",2012,1335415,592927,742488,47769,87265,349551,196538,"60.61"
"Palm",2010,1320134,587432,732702,45833,98603,379484,215460,"50.76"
"Palm",2009,1287344,558970,728374,45014,109121,406716,230819,"51.23"
"Palm",2008,1294654,562807,731847,44464,136962,482522,278757,"57.15"
"Palm",2007,1295033,562781,732252,43777,170683,589220,343066,"50.45"
"Palm",2006,1287987,561330,726657,41938,185307,648158,378620,"42.55"
"Palm",2005,1265900,559438,706462,40464,155922,562765,323353,"55.81"
"Palm",2004,1242270,557228,685042,38873,123294,451712,257155,"57.51"
"Palm",2003,1211448,554082,657366,37632,103548,381699,217066,"57.28"
"Palm",2002,1183197,545492,637705,36550,89787,335138,189458,"58.15"
"Palm",2001,1154464,531434,623030,35957,79673,298540,168500,"59.87"
"Palm",2020,1466494,639000,827494,61865,171184,565746,352830,"52.04"
"Palm",2011,1325758,590046,735712,46322,88451,351915,198261,"46.79"
"Pasco",2020,542638,495439,47199,44197,123547,321817,216692,"71.6"
"Pasco",2019,527122,481604,45518,40995,112867,303263,201263,"59.48"
"Pasco",2018,515077,470721,44356,39196,106459,292967,192261,"62.27"
"Pasco",2017,505709,461727,43982,38247,96325,277131,178852,"50.56"
"Pasco",2016,495868,452857,43011,37204,85374,255580,162370,"52.68"
"Pasco",2015,487588,445191,42397,36428,76642,236495,148044,"55.39"
"Pasco",2014,479340,437620,41720,35315,71766,226110,139506,"60.92"
"Pasco",2013,473566,432770,40796,34540,66307,209305,127661,"52.77"
"Pasco",2012,468562,428319,40243,33764,60586,189186,114827,"60.38"
"Pasco",2011,466533,426604,39929,33342,64003,194938,118976,"54.13"
"Pasco",2010,464697,424912,39785,32995,74182,218007,133530,"46.73"
"Pasco",2009,439786,398443,41343,32339,81932,237152,145225,"54.26"
"Pasco",2008,438668,397069,41599,32619,102999,288112,178097,"44.51"
"Pasco",2007,434425,392598,41827,31890,123627,339559,211547,"43.27"
"Pasco",2006,424355,382872,41483,31057,130986,359132,224234,"41.87"
"Pasco",2005,406898,366570,40328,29432,109329,306681,189636,"52.9"
"Pasco",2004,389776,350110,39666,28720,87544,247541,153401,"62.12"
"Pasco",2003,375318,336478,38840,27351,76527,215931,134584,"61.46"
"Pasco",2002,361468,323321,38147,25602,69296,198026,122206,"62.6"
"Pasco",2001,352380,314593,37787,24562,63648,184673,112838,"49.98"
"Pinellas",2019,978045,277559,700486,50809,139421,413039,240560,"61.7"
"Pinellas",2018,970532,276490,694042,49283,130343,394868,227545,"59.69"
"Pinellas",2017,962003,276511,685492,47743,118001,369448,210151,"51.23"
"Pinellas",2016,954569,275966,678603,46938,107098,345881,194160,"53.76"
"Pinellas",2015,944971,274411,670560,46044,95479,318794,174693,"56.42"
"Pinellas",2014,933258,272348,660910,44758,86695,297497,160433,"56.11"
"Pinellas",2013,926610,271227,655383,43494,78247,273741,145137,"52.19"
"Pinellas",2012,920381,270109,650272,43960,70602,247684,129642,"56.83"
"Pinellas",2011,918496,270559,647937,42370,71876,248653,131142,"60.43"
"Pinellas",2010,916542,270494,646048,41102,83508,277418,149303,"47.1"
"Pinellas",2009,931113,271478,659635,39961,91125,297814,158934,"54.14"
"Pinellas",2008,938461,273608,664853,39285,111227,355642,190436,"47.57"
"Pinellas",2007,944199,276363,667836,38009,134193,424752,227848,"41.62"
"Pinellas",2006,948102,280487,667615,36960,140266,447846,239736,"43.38"
"Pinellas",2005,947744,283059,664685,35586,119327,390147,205918,"45.29"
"Pinellas",2004,943640,284306,659334,34311,96851,319231,169894,"65.19"
"Pinellas",2003,939864,284932,654932,33117,84672,279811,150378,"59.98"
"Pinellas",2002,933994,285490,648504,32160,75191,250076,134351,"59.9"
"Pinellas",2001,929208,284867,644341,31742,67619,225332,120455,"50.56"
"Pinellas",2020,984054,277494,706560,54720,151933,440976,260354,"51.99"
"Polk",2020,715090,437717,277373,46786,139486,276971,204331,"51.45"
"Polk",2019,690606,423366,267240,43809,129781,262079,191942,"57.95"
"Polk",2018,673028,413182,259846,42378,120332,248683,180522,"58.65"
"Polk",2017,661645,407963,253682,41387,108281,231203,165260,"51.19"
"Polk",2016,646989,399263,247726,40245,98164,216826,151747,"55.48"
"Polk",2015,633052,391371,241681,39354,89708,204761,140539,"57.71"
"Polk",2014,623174,385924,237250,38504,83159,195234,131638,"58.46"
"Polk",2013,613950,381496,232454,37485,75142,178954,117435,"51.93"
"Polk",2012,606888,378315,228573,36954,68573,165509,105583,"48.61"
"Polk",2010,602095,375622,226473,35676,81137,192053,123046,"50.94"
"Polk",2009,584343,363807,220536,35485,95353,217904,140782,"47.69"
"Polk",2008,585733,365265,220468,35195,119843,267575,174853,"50.29"
"Polk",2007,581058,362801,218257,34394,134790,304025,199522,"39.23"
"Polk",2006,565049,354143,210906,33530,131784,306319,198376,"39.87"
"Polk",2005,541840,338250,203590,32235,106290,254435,160197,"60.44"
"Polk",2004,528389,328359,200030,31163,88304,210201,132069,"55.48"
"Polk",2003,511929,316613,195316,30277,80671,191426,120219,"57.67"
"Polk",2002,502385,311853,190532,29505,75709,181451,112630,"66.28"
"Polk",2001,496112,309744,186368,28890,72517,174709,107639,"53.83"
"Polk",2011,604792,377425,227367,36189,69442,167476,105916,"51.88"
"Putnam",2020,73723,58386,15337,43326,71183,248140,140032,"54.12"
"Putnam",2019,73268,58015,15253,39365,61905,228574,126405,"51.72"
"Putnam",2018,72981,57857,15124,38128,55865,212026,115579,"69.05"
"Putnam",2017,73176,58025,15151,36873,51119,201497,105806,"69.92"
"Putnam",2016,72972,57963,15009,36249,47573,191202,98161,"43.41"
"Putnam",2015,72756,57876,14880,35944,45121,193735,94120,"47.6"
"Putnam",2014,72523,57706,14817,34731,41632,184300,86739,"57.74"
"Putnam",2013,72605,57902,14703,34152,38040,168800,79076,"52.24"
"Putnam",2012,73158,58453,14705,34132,34848,155131,72559,"52.57"
"Putnam",2011,74052,58967,15085,34507,34656,154198,72308,"47.37"
"Putnam",2010,74364,59213,15151,33990,36906,164085,77347,"41.49"
"Putnam",2009,74608,58673,15935,33920,40339,179193,84886,"54.55"
"Putnam",2008,74989,58901,16088,32591,48083,214507,101887,"53.02"
"Putnam",2007,74799,58676,16123,31508,56094,253636,121675,"49.22"
"Putnam",2006,74416,58317,16099,31251,49695,230190,110855,"33.55"
"Putnam",2005,73764,57947,15817,30256,39582,186134,87895,"60.56"
"Putnam",2004,73226,57727,15499,28918,33712,158318,74590,"61.34"
"Putnam",2003,71971,56778,15193,28389,29689,141856,67541,"55.04"
"Putnam",2002,71329,56418,14911,27036,29048,137222,65800,"57.07"
"Putnam",2001,70820,56145,14675,27575,28050,129161,62927,"52.39"
"Santa",2020,184653,167449,17204,49029,228236,528312,347745,"72.62"
"Santa",2019,179054,162133,16921,45637,220232,513466,337398,"48.18"
"Santa",2018,174887,158331,16556,37946,211908,500936,328140,"70.32"
"Santa",2017,170835,154334,16501,36840,200181,483254,314419,"73.16"
"Santa",2016,167009,150615,16394,36377,190162,468114,301860,"53.97"
"Santa",2015,162925,147105,15820,35179,179713,449745,287727,"59.88"
"Santa",2014,159785,144117,15668,38802,170865,434691,276364,"65.19"
"Santa",2013,157317,141769,15548,37341,154639,402852,253520,"65.44"
"Santa",2012,155390,139935,15455,36945,143267,380226,237499,"55.81"
"Santa",2011,154901,139499,15402,36785,144045,382579,238992,"42.01"
"Santa",2010,151372,136250,15122,36148,158349,415626,259963,"51.9"
"Santa",2009,144508,130194,14314,35777,170238,447842,275909,"80.47"
"Santa",2008,144136,129859,14277,35820,201145,521809,321411,"55.61"
"Santa",2007,142144,128050,14094,35536,233572,602886,374594,"54.26"
"Santa",2006,141428,127411,14017,34594,234703,604124,373687,"42.86"
"Santa",2005,136443,122654,13789,32453,199671,523882,317515,"70.65"
"Santa",2004,133721,119833,13888,31029,168248,444532,269224,"72.09"
"Santa",2003,128889,115271,13618,29722,148091,392506,237515,"65.85"
"Santa",2002,124956,111412,13544,28944,136019,363028,219034,"64.09"
"Santa",2001,121370,107881,13489,28060,125507,336098,203374,"49.55"
"Sarasota",2020,438816,274939,163877,44970,165955,320166,237730,"69.63"
"Sarasota",2019,426275,268026,158249,42396,157460,307259,227499,"48.98"
"Sarasota",2018,417442,263636,153806,47359,149322,296336,217534,"59.85"
"Sarasota",2017,407260,258594,148666,45261,136999,278493,200837,"62.34"
"Sarasota",2016,399538,254863,144675,43614,123373,258390,182569,"57.47"
"Sarasota",2015,392090,251065,141025,42890,106182,230838,159029,"54.65"
"Sarasota",2014,387140,248619,138521,36727,94101,210104,141890,"57.06"
"Sarasota",2013,385292,247767,137525,36173,81495,186983,122293,"58.91"
"Sarasota",2012,383664,247070,136594,34921,73654,173520,109119,"53.24"
"Sarasota",2011,381319,246073,135246,34615,73516,174263,107625,"43.98"
"Sarasota",2010,379448,244936,134512,34070,76743,181912,111826,"51.1"
"Sarasota",2009,389320,253525,135795,34080,85336,198547,123465,"44.3"
"Sarasota",2008,393608,254891,138717,34837,122299,269496,174338,"46.29"
"Sarasota",2007,387461,250858,136603,35555,165963,358538,238174,"35.92"
"Sarasota",2006,379386,249601,129785,33814,182440,393699,263176,"49.91"
"Sarasota",2005,367867,246147,121720,32109,152393,339570,220238,"57.63"
"Sarasota",2004,358307,242852,115455,30977,120326,274832,175505,"51.98"
"Sarasota",2003,348761,238613,110148,29079,98148,227900,144195,"66.92"
"Sarasota",2002,339684,234601,105083,27745,82968,195031,121923,"57.1"
"Sarasota",2001,334023,231939,102084,26878,74026,174872,109767,"53.2"
"Seminole",2020,476727,226717,250010,41711,160098,363426,237782,"54.96"
"Seminole",2019,471735,224258,247477,39336,147410,339009,220218,"53.89"
"Seminole",2018,463560,220399,243161,48718,137837,321680,207677,"52.63"
"Seminole",2017,454757,217839,236918,46699,128847,304183,195521,"50.51"
"Seminole",2016,449124,215885,233239,44588,117658,282175,180440,"48.99"
"Seminole",2015,442903,213465,229438,43653,113929,276905,175631,"46.66"
"Seminole",2014,437086,211635,225451,33901,109318,271316,170437,"58.13"
"Seminole",2013,431074,210222,220852,33117,106652,266138,166272,"48.02"
"Seminole",2012,428104,209974,218130,33330,100746,251406,156266,"45.66"
"Seminole",2011,424587,208627,215960,32737,103101,256196,158900,"50.9"
"Seminole",2010,422718,207308,215410,32486,110285,273101,168951,"43.34"
"Seminole",2009,423759,206308,217451,32508,115797,284246,175154,"47.45"
"Seminole",2008,426413,206899,219514,32107,127077,310407,190870,"56.18"
"Seminole",2007,425698,208419,217279,31966,141821,349420,213350,"39.97"
"Seminole",2006,420667,207594,213073,32641,148042,372094,227873,"39.31"
"Seminole",2005,411744,203021,208723,29788,126930,329635,196301,"58.72"
"Seminole",2004,403361,199482,203879,27768,101927,259624,154943,"57.02"
"Seminole",2003,394900,194878,200022,26412,91037,228367,137980,"51.87"
"Seminole",2002,387626,191110,196516,25004,85528,214219,129737,"67.09"
"Seminole",2001,377960,186521,191439,25440,82748,207957,125833,"52.93"
"St. Johns",2020,261900,239740,22160,51643,195393,524873,289543,"56.13"
"St. Johns",2019,254412,233008,21404,47750,185717,504581,275585,"48"
"St. Johns",2018,238742,218006,20736,45475,180340,497192,269234,"61.19"
"St. Johns",2017,229715,208576,21139,43395,173821,489805,261721,"68.44"
"St. Johns",2016,220257,199337,20920,43614,165758,479077,252919,"43.36"
"St. Johns",2015,213566,192890,20676,40361,149226,446848,230899,"47.52"
"St. Johns",2014,207443,187002,20441,41603,134612,413711,209002,"56.86"
"St. Johns",2013,201541,181302,20239,40567,123220,387144,192426,"54.29"
"St. Johns",2012,196071,176128,19943,39908,107560,348400,169179,"54.2"
"St. Johns",2011,192852,172963,19889,39166,106546,349054,168334,"45.69"
"St. Johns",2010,190039,170308,19731,38669,112716,368088,177976,"36.38"
"St. Johns",2009,183572,163044,20528,38454,120903,390061,188750,"59.43"
"St. Johns",2008,181180,160414,20766,38200,152866,466632,234805,"51.18"
"St. Johns",2007,173935,153306,20629,37737,191959,568439,292827,"51.72"
"St. Johns",2006,165291,145025,20266,37363,221019,650240,340783,"32.75"
"St. Johns",2005,157278,137415,19863,35455,188648,569431,291303,"62.12"
"St. Johns",2004,149336,129759,19577,33367,145346,445660,223698,"54.7"
"St. Johns",2003,139849,120773,19076,31416,125947,388183,195157,"52.11"
"St. Johns",2002,133953,115395,18558,29213,111311,348054,173440,"52.31"
"St. Johns",2001,128604,110372,18232,29030,99831,313551,156407,"54.3"
"St. Lucie",2020,322265,74214,248051,53893,195548,415434,296390,"56.13"
"St. Lucie",2019,309359,73157,236202,50134,183907,395602,280520,"55.72"
"St. Lucie",2018,302432,72629,229803,41155,172424,380227,267686,"45.33"
"St. Lucie",2017,297634,72298,225336,40043,158027,358301,249648,"62.62"
"St. Lucie",2016,292826,71639,221187,38714,143574,336188,231050,"59.98"
"St. Lucie",2015,287749,70901,216848,38021,130141,313359,211452,"47.47"
"St. Lucie",2014,282821,70459,212362,41919,122987,302708,201033,"50.04"
"St. Lucie",2013,281151,70920,210231,40948,109339,275633,181014,"48.32"
"St. Lucie",2012,280355,70872,209483,40249,94631,244623,158319,"49.01"
"St. Lucie",2011,279696,71256,208440,39359,94925,245086,159012,"49.19"
"St. Lucie",2010,277789,71006,206783,38512,109488,272009,180976,"43.37"
"St. Lucie",2009,272864,72725,200139,38404,128839,304828,204347,"41.31"
"St. Lucie",2008,276585,73815,202770,38860,164174,376577,253124,"60.74"
"St. Lucie",2007,271961,74039,197922,38582,196425,448543,304016,"47.99"
"St. Lucie",2006,259315,73432,185883,37815,199166,461494,313380,"35.07"
"St. Lucie",2005,240039,71711,168328,37126,159000,377816,251352,"58.74"
"St. Lucie",2004,226216,71389,154827,35137,126665,301724,200841,"56.85"
"St. Lucie",2003,211898,69472,142426,33629,112999,270351,180337,"53.81"
"St. Lucie",2002,203360,67674,135686,32637,103168,249086,165860,"51.72"
"St. Lucie",2001,198253,67145,131108,31951,94987,232081,153141,"57.53"
"Sumter",2020,141422,118814,22608,45810,214832,442929,297353,"50.65"
"Sumter",2019,128633,110769,17864,42787,204821,424326,284220,"53.68"
"Sumter",2018,124935,110285,14650,41043,192544,399120,267079,"59.41"
"Sumter",2017,120700,107158,13542,39789,183220,380257,254539,"53.5"
"Sumter",2016,118577,105493,13084,38010,177176,366569,247293,"47.85"
"Sumter",2015,115657,103282,12375,36956,177640,370466,249876,"47.65"
"Sumter",2014,111125,98924,12201,36931,172632,363730,243689,"56.9"
"Sumter",2013,105104,93122,11982,37574,153049,322788,215657,"48.46"
"Sumter",2012,100198,88363,11835,35894,140622,298295,198611,"53.17"
"Sumter",2011,96615,84815,11800,34917,139993,298017,197715,"48.64"
"Sumter",2010,93420,81817,11603,32739,144069,305611,201161,"46.61"
"Sumter",2009,95326,85788,9538,32547,147026,313636,204634,"48.96"
"Sumter",2008,93034,83445,9589,32499,157990,341323,223096,"46.44"
"Sumter",2007,89771,80202,9569,33831,172160,371524,244142,"45.3"
"Sumter",2006,82599,73393,9206,30828,163270,355035,231899,"38.88"
"Sumter",2005,74052,65306,8746,30030,141942,311830,201763,"55.84"
"Sumter",2004,66416,57811,8605,29490,123790,274128,178084,"55.75"
"Sumter",2003,63001,54560,8441,29192,112835,246694,162431,"58.47"
"Sumter",2002,61348,52965,8383,28090,105457,230595,151743,"64.42"
"Sumter",2001,56932,48575,8357,28247,99330,219235,141465,"51.1"
"Suwannee",2020,45463,37827,7636,37737,78069,240173,142686,"46.82"
"Suwannee",2019,45423,37777,7646,35802,75552,236659,138865,"46.02"
"Suwannee",2018,44879,37353,7526,34894,72679,230722,134523,"67.33"
"Suwannee",2017,44690,37139,7551,33592,68703,219646,128076,"54.21"
"Suwannee",2016,44349,36831,7518,32359,63822,204322,118571,"50.81"
"Suwannee",2015,44452,36912,7540,31346,58113,187854,108539,"49.16"
"Suwannee",2014,44168,36625,7543,30421,51716,170477,97037,"71.38"
"Suwannee",2013,43873,36379,7494,29720,47157,155019,87853,"58.17"
"Suwannee",2012,43796,36265,7531,28871,43450,142820,80962,"67.29"
"Suwannee",2011,43215,35652,7563,28244,42802,140102,79993,"47.27"
"Suwannee",2010,41551,33989,7562,28144,45123,148029,84321,"47.53"
"Suwannee",2009,40230,32857,7373,27657,48835,161177,91461,"50.31"
"Suwannee",2008,40927,33503,7424,28370,57131,188867,106721,"49.69"
"Suwannee",2007,39608,32053,7555,27494,66798,222523,124545,"40.43"
"Suwannee",2006,38799,31454,7345,27157,68253,230073,127007,"39.74"
"Suwannee",2005,38174,30908,7266,25842,58234,201319,108354,"58.4"
"Suwannee",2004,37713,30475,7238,25078,46314,162066,86331,"62.19"
"Suwannee",2003,37198,29976,7222,23240,38101,137485,66491,"60.56"
"Suwannee",2002,35727,28532,7195,22365,NULL,NULL,NULL,"50.97"
"Suwannee",2001,35695,28527,7168,21697,NULL,NULL,NULL,"43.74"
"Taylor",2020,22436,15499,6937,41784,55303,203648,110545,"53.63"
"Taylor",2019,22458,15427,7031,40749,52428,197140,106387,"48.06"
"Taylor",2018,22283,15258,7025,40110,50694,192110,103411,"77.75"
"Taylor",2017,22295,15341,6954,39208,47424,182994,97088,"53.76"
"Taylor",2016,22478,15504,6974,38014,44248,171967,89980,"56.83"
"Taylor",2015,22824,15808,7016,40705,40367,159669,83182,"48.61"
"Taylor",2014,22932,15863,7069,37220,35877,144246,73924,"68.83"
"Taylor",2013,23018,15987,7031,37593,32637,132032,67644,"59.58"
"Taylor",2012,22898,15861,7037,36491,29254,119237,61303,"65.36"
"Taylor",2011,22500,15523,6977,36468,28686,118649,60739,"41.98"
"Taylor",2010,22570,15553,7017,35625,29741,123492,63102,"55.28"
"Taylor",2009,23164,16349,6815,33708,32357,134443,68569,"54.71"
"Taylor",2008,23199,16367,6832,33167,38093,158640,81374,"53.56"
"Taylor",2007,22516,15720,6796,33075,44807,188350,96260,"38.76"
"Taylor",2006,21471,14632,6839,30922,46051,195064,99766,"39.59"
"Taylor",2005,21310,14478,6832,30072,40193,172632,87957,"62.84"
"Taylor",2004,20941,14118,6823,28618,32839,141737,73013,"61.24"
"Taylor",2003,20646,13822,6824,28430,28245,121681,63595,"70.02"
"Taylor",2002,19800,12973,6827,27509,26128,112148,58796,"57.39"
"Taylor",2001,19521,12674,6847,27425,24014,103485,54916,"42.13"
"Union",2020,15410,13033,2377,39849,80851,241062,152443,"53.63"
"Union",2019,15505,13094,2411,38684,79489,232410,148207,"45.22"
"Union",2018,15867,13461,2406,38187,73711,219304,140316,"58.11"
"Union",2017,15947,13549,2398,36174,65530,200761,126425,"59.96"
"Union",2016,15887,13452,2435,35374,61031,187873,119872,"45.8"
"Union",2015,15918,13449,2469,34267,54478,169862,109014,"47.87"
"Union",2014,15647,13124,2523,34270,49469,155302,99987,"60.55"
"Union",2013,15483,12976,2507,34060,45190,141391,91497,"52.63"
"Union",2012,15510,12971,2539,33684,41342,129698,83705,"64.19"
"Union",2011,15473,12935,2538,33075,41741,129591,84923,"49.32"
"Union",2010,15535,12976,2559,33411,44297,138074,89888,"44.4"
"Union",2009,15576,12943,2633,33539,47618,149836,96608,"53.59"
"Union",2008,15974,13337,2637,31997,56328,172348,113163,"49.18"
"Union",2007,15722,13013,2709,31775,65460,199386,131732,"41.12"
"Union",2006,15028,12366,2662,31598,64456,194580,127627,"40.75"
"Union",2005,15046,12384,2662,30772,59903,191986,121176,"55.52"
"Union",2004,14620,11937,2683,29422,NULL,NULL,NULL,"63.16"
"Union",2003,13726,11354,2372,27665,NULL,NULL,NULL,"58.36"
"Union",2002,13794,11421,2373,26347,NULL,NULL,NULL,"56.11"
"Union",2001,13521,11251,2270,25999,NULL,NULL,NULL,"43.76"
"Volusia",2020,551588,119211,432377,44406,160836,344892,223674,"53.98"
"Volusia",2019,538763,118208,420555,41241,150548,328325,210320,"56.04"
"Volusia",2018,531062,116678,414384,40085,141057,314044,198570,"58.14"
"Volusia",2017,523405,116705,406700,39060,127712,293544,182064,"53.94"
"Volusia",2016,517411,115969,401442,37849,112207,269171,162722,"45.41"
"Volusia",2015,510494,115656,394838,37196,101177,251428,148942,"46.51"
"Volusia",2014,503851,115057,388794,36038,94333,240456,140542,"61.32"
"Volusia",2013,498978,115300,383678,34947,84638,221499,126708,"50.5"
"Volusia",2012,497145,115757,381388,34847,75242,200735,112766,"45.86"
"Volusia",2011,495400,115830,379570,33861,77106,205403,116231,"47.19"
"Volusia",2010,494593,116655,377938,33726,88237,227336,131159,"41.35"
"Volusia",2009,507105,116448,390657,33021,103630,259321,151313,"46.8"
"Volusia",2008,510750,117584,393166,32938,128611,312452,184106,"54.12"
"Volusia",2007,508014,116542,391472,32196,156900,380275,225245,"45.01"
"Volusia",2006,503844,115720,388124,31197,163238,403997,238134,"36.52"
"Volusia",2005,494649,114961,379688,29927,132166,340170,195580,"64.22"
"Volusia",2004,484261,113678,370583,29346,104998,273138,157674,"62.17"
"Volusia",2003,470770,111783,358987,28037,90050,233920,135263,"54.21"
"Volusia",2002,459737,109196,350541,26947,80867,210292,121074,"61.06"
"Volusia",2001,452050,107916,344134,26064,74030,192345,111422,"58"
"Wakulla",2020,33981,33121,860,42469,110345,289990,188782,"52.41"
"Wakulla",2019,32976,32107,869,37752,106108,280381,182534,"40.94"
"Wakulla",2018,31943,31193,750,35867,102026,271232,176520,"73.48"
"Wakulla",2017,31909,31165,744,35143,97289,257375,167413,"53.18"
"Wakulla",2016,31599,30848,751,33996,90742,239188,154893,"57.23"
"Wakulla",2015,31283,30543,740,33230,84139,220938,142373,"51.36"
"Wakulla",2014,31285,30555,730,32543,77958,204709,131533,"66.32"
"Wakulla",2013,30869,30134,735,32026,71838,188807,120762,"64.66"
"Wakulla",2012,30771,30037,734,30787,66138,174032,110869,"55.48"
"Wakulla",2011,30877,30131,746,30815,66241,174344,110723,"35.67"
"Wakulla",2010,30776,30026,750,32946,70546,185731,117973,"53.65"
"Wakulla",2009,31791,31050,741,32352,76727,203079,128704,"56.37"
"Wakulla",2008,30717,29970,747,31927,89680,238508,150564,"56.2"
"Wakulla",2007,29417,28676,741,30586,100186,269305,169135,"41.49"
"Wakulla",2006,28393,27663,730,29317,100040,269847,169160,"44.93"
"Wakulla",2005,26867,26143,724,27767,87109,237550,147948,"64.11"
"Wakulla",2004,25505,24784,721,26967,69998,191287,119722,"54.48"
"Wakulla",2003,24938,24256,682,25445,59693,162698,102413,"61.33"
"Wakulla",2002,24217,23531,686,24454,54210,148400,92923,"57.26"
"Wakulla",2001,23807,23126,681,33264,48794,135821,84025,"56.77"
"Walton",2020,74724,62698,12026,44056,213827,1044915,436967,"58.05"
"Walton",2019,70071,59512,10559,40842,202054,1004944,416689,"52.35"
"Walton",2018,67656,57720,9936,38543,191790,962029,396943,"74.77"
"Walton",2017,65301,55989,9312,37312,179733,915238,373033,"68.6"
"Walton",2016,62943,53856,9087,35582,172035,878089,355285,"59.71"
"Walton",2015,60687,51969,8718,34151,165099,852129,344346,"60.28"
"Walton",2014,59793,51305,8488,32801,152370,796803,323185,"66.95"
"Walton",2013,57779,49537,8242,32148,139750,730674,297071,"76.64"
"Walton",2012,56965,48818,8147,31658,131644,680386,276029,"60.79"
"Walton",2011,55450,47808,7642,30674,131232,679877,275242,"46.55"
"Walton",2010,55043,47435,7608,30447,144957,743263,297911,"52.49"
"Walton",2009,57917,50544,7373,30373,148882,804065,310996,"78.79"
"Walton",2008,57784,50370,7414,30522,174270,954283,360538,"57.02"
"Walton",2007,57093,49420,7673,30861,199286,1131838,417397,"48.89"
"Walton",2006,55786,48034,7752,30092,213512,1218912,455779,"40.76"
"Walton",2005,53525,46230,7295,28773,184821,1083283,398086,"65.21"
"Walton",2004,50543,43412,7131,26453,142711,847337,304343,"61.6"
"Walton",2003,47066,40002,7064,25092,122049,715657,254572,"74.27"
"Walton",2002,45521,38474,7047,24107,109561,651715,227865,"63.21"
"Walton",2001,42542,35598,6944,23060,102039,618415,212000,"50.19"
"Washington",2020,25334,20157,5177,37897,66126,208237,119074,"68.23"
"Washington",2019,25387,20164,5223,35994,62442,201398,113503,"48.21"
"Washington",2018,25129,19966,5163,35465,59381,193713,108928,"73.8"
"Washington",2017,24985,19869,5116,34625,55413,179823,101328,"57.09"
"Washington",2016,24888,19768,5120,33578,51488,169044,94775,"61.88"
"Washington",2015,24975,19888,5087,33389,48463,158784,89607,"63.82"
"Washington",2014,24959,19880,5079,32248,44284,145775,82425,"64.95"
"Washington",2013,24793,19646,5147,31727,41047,134401,75819,"76.8"
"Washington",2012,24922,19730,5192,30819,37797,123736,69543,"58.25"
"Washington",2011,24638,19255,5383,30508,36941,123528,68989,"45.47"
"Washington",2010,24896,19540,5356,30603,38616,129778,73202,"46.44"
"Washington",2009,24721,19500,5221,31078,42610,142311,80786,"69.05"
"Washington",2008,24779,19341,5438,29124,50889,170000,96662,"60.67"
"Washington",2007,23719,18222,5497,28704,59708,201975,114928,"42.92"
"Washington",2006,23073,17571,5502,27228,NULL,NULL,NULL,"41.88"
"Washington",2005,23097,17661,5436,27130,NULL,NULL,NULL,"59.78"
"Washington",2004,22434,17070,5364,25371,NULL,NULL,NULL,"59.24"
"Washington",2003,21913,16669,5244,25061,NULL,NULL,NULL,"67.16"
"Washington",2002,21649,16359,5290,24485,NULL,NULL,NULL,"65.33"
"Washington",2001,21437,16167,5270,24273,NULL,NULL,NULL,"50.18"
