County,CountywidePopulation,Unincorporated Population,% of Total,Incorporated Population,% of Total.1,Year
Alachua *,271588,107807,0.396950528,163781,0.603049472,2020
Baker *,28532,20889,0.732125333,7643,0.267874667,2020
Bay,174410,77729,0.445668253,96681,0.554331747,2020
Bradford,28725,21708,0.755718016,7017,0.244281984,2020
Brevard,606671,225616,0.371891849,381055,0.628108151,2020
Broward *,1932212,15375,0.007957201,1916837,0.992042799,2020
Calhoun,14489,11539,0.796397267,2950,0.203602733,2020
Charlotte,187904,167499,0.891407314,20405,0.108592686,2020
Citrus,149383,138818,0.929275754,10565,0.070724246,2020
Clay,219575,200655,0.913833542,18920,0.086166458,2020
Collier,387450,348362,0.899114724,39088,0.100885276,2020
Columbia *,70617,57709,0.817211153,12908,0.182788847,2020
DeSoto,37082,29096,0.784639448,7986,0.215360552,2020
Dixie,16663,14768,0.88627498,1895,0.11372502,2020
Duval,982080,0,0.0,982080,1.0,2020
Escambia,323714,266434,0.823053683,57280,0.176946317,2020
Flagler,114173,16141,0.141373179,98032,0.858626821,2020
Franklin,11864,6874,0.579399865,4990,0.420600135,2020
Gadsden *,46226,27380,0.592307359,18846,0.407692641,2020
Gilchrist,18269,15104,0.826755706,3165,0.173244294,2020
Glades,13609,11831,0.869351165,1778,0.130648835,2020
Gulf,14724,8991,0.610635697,5733,0.389364303,2020
Hamilton,14570,10235,0.70247083,4335,0.29752917,2020
Hardee,27443,17500,0.637685384,9943,0.362314616,2020
Hendry,40953,27781,0.678363001,13172,0.321636999,2020
Hernando,192186,183194,0.953211993,8992,0.046788007,2020
Highlands,104834,79585,0.759152565,25249,0.240847435,2020
Hillsborough *,1478759,1019128,0.689177885,459631,0.310822115,2020
Holmes,20001,15847,0.792310384,4154,0.207689616,2020
Indian River,158834,105833,0.666311999,53001,0.333688001,2020
Jackson *,46587,31199,0.669693262,15388,0.330306738,2020
Jefferson,14394,11957,0.830693344,2437,0.169306656,2020
Lafayette,8690,7473,0.85995397,1217,0.14004603,2020
Lake,366742,167901,0.457817757,198841,0.542182243,2020
Lee,750493,368415,0.490897317,382078,0.509102683,2020
Leon,299484,100857,0.336769243,198627,0.663230757,2020
Levy,41699,32220,0.7726804,9479,0.2273196,2020
Liberty,8575,7663,0.893644315,912,0.106355685,2020
Madison,18954,14964,0.789490345,3990,0.210509655,2020
Manatee,398503,317022,0.79553228,81481,0.20446772,2020
Marion,368135,297855,0.809091773,70280,0.190908227,2020
Martin,161301,134284,0.832505688,27017,0.167494312,2020
Miami-Dade *,2832794,1220446,0.430827656,1612348,0.569172344,2020
Monroe,77823,36477,0.468717474,41346,0.531282526,2020
Nassau,89258,71301,0.798819153,17957,0.201180847,2020
Okaloosa,203951,116954,0.57344166,86997,0.42655834,2020
Okeechobee,42112,36424,0.864931611,5688,0.135068389,2020
Orange *,1415260,893300,0.631191442,521960,0.368808558,2020
Osceola,387055,260514,0.673067135,126541,0.326932865,2020
Palm Beach *,1466494,639000,0.435733116,827494,0.564266884,2020
Pasco,542638,495439,0.913019361,47199,0.086980639,2020
Pinellas *,984054,277494,0.281990622,706560,0.718009378,2020
Polk,715090,437717,0.612114559,277373,0.387885441,2020
Putnam,73723,58386,0.791964516,15337,0.208035484,2020
Santa Rosa,184653,167449,0.90683065,17204,0.09316935,2020
Sarasota,438816,274939,0.626547346,163877,0.373452654,2020
Seminole,476727,226717,0.475569875,250010,0.524430125,2020
St. Johns,261900,239740,0.915387553,22160,0.084612447,2020
St. Lucie,322265,74214,0.230288738,248051,0.769711262,2020
Sumter,141422,118814,0.840138027,22608,0.159861973,2020
Suwannee,45463,37827,0.832039241,7636,0.167960759,2020
Taylor,22436,15499,0.690809413,6937,0.309190587,2020
Union,15410,13033,0.845749513,2377,0.154250487,2020
Volusia,551588,119211,0.216123266,432377,0.783876734,2020
Wakulla,33981,33121,0.97469174,860,0.02530826,2020
Walton,74724,62698,0.839061078,12026,0.160938922,2020
Washington,25334,20157,0.795650114,5177,0.204349886,2020
Alachua,267306,106299,0.397667841,161007,0.602332159,2019
Baker,28249,20838,0.73765443,7411,0.26234557,2019
Bay,167283,75986,0.454236234,91297,0.545763766,2019
Bradford,28682,21725,0.757443693,6957,0.242556307,2019
Brevard,594469,221729,0.372986649,372740,0.627013351,2019
Broward,1919644,15304,0.007972312,1904340,0.992027688,2019
Calhoun,14067,11136,0.791640009,2931,0.208359991,2019
Charlotte,181770,161809,0.890185399,19961,0.109814601,2019
Citrus,147744,136970,0.927076565,10774,0.072923435,2019
Clay,215246,196607,0.913406056,18639,0.086593944,2019
Collier,376706,338008,0.897272674,38698,0.102727326,2019
Columbia,70492,57667,0.818064461,12825,0.181935539,2019
DeSoto,36065,28295,0.784555663,7770,0.215444337,2019
Dixie,16610,14767,0.889042745,1843,0.110957255,2019
Duval,970672,0,0.0,970672,1.0,2019
Escambia,321134,264282,0.822964868,56852,0.177035132,2019
Flagler,110635,15499,0.140091291,95136,0.859908709,2019
Franklin,12273,7051,0.574513159,5222,0.425486841,2019
Gadsden,46277,27769,0.600060505,18508,0.399939495,2019
Gilchrist,17766,14867,0.836823145,2899,0.163176855,2019
Glades,13121,11362,0.865940096,1759,0.134059904,2019
Gulf,13082,7652,0.584925852,5430,0.415074148,2019
Hamilton,14600,10054,0.688630137,4546,0.311369863,2019
Hardee,27385,17455,0.637392733,9930,0.362607267,2019
Hendry,40120,27040,0.673978066,13080,0.326021934,2019
Hernando,188358,179688,0.95397063,8670,0.04602937,2019
Highlands,103434,78463,0.758580351,24971,0.241419649,2019
Hillsborough,1444870,988250,0.683971568,456620,0.316028432,2019
Holmes,20049,15753,0.785724974,4296,0.214275026,2019
Indian River,154939,102713,0.662925409,52226,0.337074591,2019
Jackson,46969,31267,0.665694394,15702,0.334305606,2019
Jefferson,14776,12327,0.834258257,2449,0.165741743,2019
Lafayette,8482,7265,0.856519689,1217,0.143480311,2019
Lake,357247,165760,0.4639927,191487,0.5360073,2019
Lee,735148,361315,0.491486068,373833,0.508513932,2019
Leon,296499,100786,0.339920202,195713,0.660079798,2019
Levy,41330,31881,0.771376724,9449,0.228623276,2019
Liberty,8772,7832,0.892840857,940,0.107159143,2019
Madison,19570,15443,0.789115994,4127,0.210884006,2019
Manatee,387414,307843,0.794609901,79571,0.205390099,2019
Marion,360421,290747,0.80668718,69674,0.19331282,2019
Martin,158598,132144,0.833200923,26454,0.166799077,2019
Miami-Dade,2812130,1212200,0.431061153,1599930,0.568938847,2019
Monroe,76212,35294,0.463102923,40918,0.536897077,2019
Nassau,85070,67804,0.797037734,17266,0.202962266,2019
Okaloosa,201514,115579,0.573553202,85935,0.426446798,2019
Okeechobee,41808,36205,0.865982587,5603,0.134017413,2019
Orange,1386080,876910,0.632654681,509170,0.367345319,2019
Osceola,370552,247878,0.668942551,122674,0.331057449,2019
Palm Beach,1447857,629451,0.434746664,818406,0.565253336,2019
Pasco,527122,481604,0.913648074,45518,0.086351926,2019
Pinellas,978045,277559,0.283789601,700486,0.716210399,2019
Polk,690606,423366,0.613035508,267240,0.386964492,2019
Putnam,73268,58015,0.791819075,15253,0.208180925,2019
Santa Rosa,179054,162133,0.905497783,16921,0.094502217,2019
Sarasota,426275,268026,0.628763122,158249,0.371236878,2019
Seminole,471735,224258,0.475389785,247477,0.524610215,2019
St. Johns,254412,233008,0.915868748,21404,0.084131252,2019
St. Lucie,309359,73157,0.236479301,236202,0.763520699,2019
Sumter,128633,110769,0.861124284,17864,0.138875716,2019
Suwannee,45423,37777,0.83167118,7646,0.16832882,2019
Taylor,22458,15427,0.686926708,7031,0.313073292,2019
Union,15505,13094,0.844501774,2411,0.155498226,2019
Volusia,538763,118208,0.219406307,420555,0.780593693,2019
Wakulla,32976,32107,0.973647501,869,0.026352499,2019
Walton,70071,59512,0.849309986,10559,0.150690014,2019
Washington,25387,20164,0.794264781,5223,0.205735219,2019
Alachua,263291,104904,0.398433672,158387,0.601566328,2018
Baker,27652,20463,0.740018805,7189,0.259981195,2018
Bay,181199,78463,0.433021154,102736,0.566978846,2018
Bradford,28057,21200,0.755604662,6857,0.244395338,2018
Brevard,583563,217902,0.373399273,365661,0.626600727,2018
Broward,1897976,15120,0.007966381,1882856,0.992033619,2018
Calhoun,15093,12030,0.797058239,3063,0.202941761,2018
Charlotte,177987,158500,0.890514476,19487,0.109485524,2018
Citrus,145721,135008,0.926482799,10713,0.073517201,2018
Clay,212034,193461,0.912405558,18573,0.087594442,2018
Collier,367347,329501,0.896974795,37846,0.103025205,2018
Columbia,69721,56847,0.815349751,12874,0.184650249,2018
DeSoto,35520,27847,0.783980856,7673,0.216019144,2018
Dixie,16489,14622,0.886773,1867,0.113227,2018
Duval,952861,0,0.0,952861,1.0,2018
Escambia,318560,262157,0.822943872,56403,0.177056128,2018
Flagler,107511,14852,0.138144004,92659,0.861855996,2018
Franklin,12009,7000,0.582896161,5009,0.417103839,2018
Gadsden,47828,29226,0.611064648,18602,0.388935352,2018
Gilchrist,17424,14539,0.834423783,2885,0.165576217,2018
Glades,13002,11262,0.866174435,1740,0.133825565,2018
Gulf,16499,10747,0.65137281,5752,0.34862719,2018
Hamilton,14621,10158,0.694754121,4463,0.305245879,2018
Hardee,27296,17498,0.641046307,9798,0.358953693,2018
Hendry,39586,26618,0.672409438,12968,0.327590562,2018
Hernando,185604,177185,0.954639986,8419,0.045360014,2018
Highlands,102525,77619,0.757073884,24906,0.242926116,2018
Hillsborough,1408864,964883,0.684865963,443981,0.315134037,2018
Holmes,20133,16044,0.796900611,4089,0.203099389,2018
Indian River,151825,100719,0.66338877,51106,0.33661123,2018
Jackson,50435,32903,0.652384257,17532,0.347615743,2018
Jefferson,14733,12321,0.836285889,2412,0.163714111,2018
Lafayette,8501,7293,0.857899071,1208,0.142100929,2018
Lake,342917,159945,0.46642482,182972,0.53357518,2018
Lee,713903,355737,0.498298788,358166,0.501701212,2018
Leon,292332,99951,0.341909199,192381,0.658090801,2018
Levy,41054,31621,0.770229454,9433,0.229770546,2018
Liberty,8915,7965,0.893438026,950,0.106561974,2018
Madison,19473,15257,0.783495096,4216,0.216504904,2018
Manatee,377826,299207,0.791917443,78619,0.208082557,2018
Marion,353898,285899,0.807857066,67999,0.192142934,2018
Martin,155556,129357,0.831578338,26199,0.168421662,2018
Miami-Dade,2779322,1203732,0.43310275,1575590,0.56689725,2018
Monroe,73940,34266,0.463429808,39674,0.536570192,2018
Nassau,82748,65692,0.793880215,17056,0.206119785,2018
Okaloosa,198152,113497,0.572777464,84655,0.427222536,2018
Okeechobee,41120,35559,0.864761673,5561,0.135238327,2018
Orange,1349597,855307,0.633749927,494290,0.366250073,2018
Osceola,352496,233608,0.662725251,118888,0.337274749,2018
Palm Beach,1433417,624941,0.4359799,808476,0.5640201,2018
Pasco,515077,470721,0.91388472,44356,0.08611528,2018
Pinellas,970532,276490,0.284884991,694042,0.715115009,2018
Polk,673028,413182,0.613915023,259846,0.386084977,2018
Putnam,72981,57857,0.792767981,15124,0.207232019,2018
Santa Rosa,174887,158331,0.905333158,16556,0.094666842,2018
Sarasota,417442,263636,0.63155121,153806,0.36844879,2018
Seminole,463560,220399,0.475448701,243161,0.524551299,2018
St. Johns,238742,218006,0.913144734,20736,0.086855266,2018
St. Lucie,302432,72629,0.240149852,229803,0.759850148,2018
Sumter,124935,110285,0.882739024,14650,0.117260976,2018
Suwannee,44879,37353,0.832304641,7526,0.167695359,2018
Taylor,22283,15258,0.684737244,7025,0.315262756,2018
Union,15867,13461,0.84836453,2406,0.15163547,2018
Volusia,531062,116678,0.219706927,414384,0.780293073,2018
Wakulla,31943,31193,0.976520677,750,0.023479323,2018
Walton,67656,57720,0.853139411,9936,0.146860589,2018
Washington,25129,19966,0.794540173,5163,0.205459827,2018
Alachua,260003,103810,0.399264624,156193,0.600735376,2017
Baker,27191,20211,0.743297415,6980,0.256702585,2017
Bay,178820,77279,0.432160832,101541,0.567839168,2017
Bradford,27642,20598,0.745170393,7044,0.254829607,2017
Brevard,575211,215142,0.37402275,360069,0.62597725,2017
Broward,1873970,15006,0.008007599,1858964,0.991992401,2017
Calhoun,15001,11943,0.796146924,3058,0.203853076,2017
Charlotte,172720,153882,0.890933302,18838,0.109066698,2017
Citrus,143801,133395,0.927636108,10406,0.072363892,2017
Clay,208549,190210,0.912063832,18339,0.087936168,2017
Collier,357470,319796,0.894609338,37674,0.105390662,2017
Columbia,68943,56121,0.814020278,12822,0.185979722,2017
DeSoto,35621,27944,0.784481065,7677,0.215518935,2017
Dixie,16726,14851,0.887899079,1875,0.112100921,2017
Duval,936811,0,0.0,936811,1.0,2017
Escambia,313381,257774,0.822557845,55607,0.177442155,2017
Flagler,105157,14463,0.137537206,90694,0.862462794,2017
Franklin,12161,6999,0.575528328,5162,0.424471672,2017
Gadsden,48263,29552,0.612311709,18711,0.387688291,2017
Gilchrist,17224,14403,0.836216907,2821,0.163783093,2017
Glades,13087,11340,0.866508749,1747,0.133491251,2017
Gulf,16297,10690,0.655948948,5607,0.344051052,2017
Hamilton,14663,9983,0.680829298,4680,0.319170702,2017
Hardee,27426,17566,0.640487129,9860,0.359512871,2017
Hendry,39057,26447,0.677138541,12610,0.322861459,2017
Hernando,181882,173799,0.955559099,8083,0.044440901,2017
Highlands,102138,77548,0.759247293,24590,0.240752707,2017
Hillsborough,1379302,941536,0.68261773,437766,0.31738227,2017
Holmes,20210,16110,0.797130134,4100,0.202869866,2017
Indian River,148962,98644,0.662209154,50318,0.337790846,2017
Jackson,50418,32764,0.649847277,17654,0.350152723,2017
Jefferson,14611,12186,0.834029156,2425,0.165970844,2017
Lafayette,8479,7253,0.855407477,1226,0.144592523,2017
Lake,331724,158877,0.478943338,172847,0.521056662,2017
Lee,698468,350230,0.501425978,348238,0.498574022,2017
Leon,287899,98274,0.341348876,189625,0.658651124,2017
Levy,41015,31558,0.76942582,9457,0.23057418,2017
Liberty,8719,7765,0.890583783,954,0.109416217,2017
Madison,19377,15249,0.786963926,4128,0.213036074,2017
Manatee,368782,291864,0.791426913,76918,0.208573087,2017
Marion,349267,281812,0.806866953,67455,0.193133047,2017
Martin,153022,133852,0.874723896,19170,0.125276104,2017
Miami-Dade,2743095,1191589,0.434395819,1551506,0.565604181,2017
Monroe,76889,36202,0.47083458,40687,0.52916542,2017
Nassau,80456,63661,0.791252362,16795,0.208747638,2017
Okaloosa,195488,111495,0.570341914,83993,0.429658086,2017
Okeechobee,41140,35574,0.864705882,5566,0.135294118,2017
Orange,1313880,834353,0.635029835,479527,0.364970165,2017
Osceola,337614,222558,0.659208445,115056,0.340791555,2017
Palm Beach,1414144,618446,0.437328872,795698,0.562671128,2017
Pasco,505709,461727,0.913029034,43982,0.086970966,2017
Pinellas,962003,276511,0.287432576,685492,0.712567424,2017
Polk,661645,407963,0.616588956,253682,0.383411044,2017
Putnam,73176,58025,0.792951241,15151,0.207048759,2017
Santa Rosa,170835,154334,0.903409723,16501,0.096590277,2017
Sarasota,407260,258594,0.634960468,148666,0.365039532,2017
Seminole,454757,217839,0.479022863,236918,0.520977137,2017
St. Johns,229715,208576,0.907977276,21139,0.092022724,2017
St. Lucie,297634,72298,0.242909076,225336,0.757090924,2017
Sumter,120700,107158,0.887804474,13542,0.112195526,2017
Suwannee,44690,37139,0.831036026,7551,0.168963974,2017
Taylor,22295,15341,0.6880915,6954,0.3119085,2017
Union,15947,13549,0.849626889,2398,0.150373111,2017
Volusia,523405,116705,0.22297265,406700,0.77702735,2017
Wakulla,31909,31165,0.976683694,744,0.023316306,2017
Walton,65301,55989,0.857398815,9312,0.142601185,2017
Washington,24985,19869,0.795237142,5116,0.204762858,2017
Alachua,257062,102298,0.397950689,154764,0.602049311,2016
Baker,26965,20071,0.744335249,6894,0.255664751,2016
Bay,176016,75806,0.430676757,100210,0.569323243,2016
Bradford,27440,20398,0.743367347,7042,0.256632653,2016
Brevard,568919,212740,0.373937239,356179,0.626062761,2016
Broward,1854513,14759,0.007958424,1839754,0.992041576,2016
Calhoun,14580,11553,0.792386831,3027,0.207613169,2016
Charlotte,170450,152082,0.892238193,18368,0.107761807,2016
Citrus,143054,132660,0.927342123,10394,0.072657877,2016
Clay,205321,187142,0.911460591,18179,0.088539409,2016
Collier,350202,313104,0.894066853,37098,0.105933147,2016
Columbia,68566,55891,0.815141615,12675,0.184858385,2016
DeSoto,35141,27513,0.782931618,7628,0.217068382,2016
Dixie,16773,14900,0.888332439,1873,0.111667561,2016
Duval,923647,0,0.0,923647,1.0,2016
Escambia,309986,254757,0.821833889,55229,0.178166111,2016
Flagler,103095,14035,0.136136573,89060,0.863863427,2016
Franklin,11916,6495,0.545065458,5421,0.454934542,2016
Gadsden,48486,29849,0.615621004,18637,0.384378996,2016
Gilchrist,16848,14023,0.832324311,2825,0.167675689,2016
Glades,13047,11375,0.871847934,1672,0.128152066,2016
Gulf,16628,10956,0.658888622,5672,0.341111378,2016
Hamilton,14665,9963,0.679372656,4702,0.320627344,2016
Hardee,27637,17803,0.644172667,9834,0.355827333,2016
Hendry,38370,26046,0.678811572,12324,0.321188428,2016
Hernando,179503,171492,0.955371219,8011,0.044628781,2016
Highlands,101531,77007,0.758458008,24524,0.241541992,2016
Hillsborough,1352797,924013,0.683038919,428784,0.316961081,2016
Holmes,20003,15916,0.795680648,4087,0.204319352,2016
Indian River,146410,96993,0.662475241,49417,0.337524759,2016
Jackson,50345,32702,0.649558049,17643,0.350441951,2016
Jefferson,14498,12055,0.831493999,2443,0.168506001,2016
Lafayette,8621,7420,0.860689015,1201,0.139310985,2016
Lake,323985,159296,0.491677084,164689,0.508322916,2016
Lee,680539,342137,0.502744148,338402,0.497255852,2016
Leon,287671,97996,0.340653038,189675,0.659346962,2016
Levy,40553,31255,0.770719799,9298,0.229280201,2016
Liberty,8736,7819,0.895032051,917,0.104967949,2016
Madison,19238,15073,0.783501403,4165,0.216498597,2016
Manatee,357591,281668,0.787682017,75923,0.212317983,2016
Marion,345749,278439,0.805321201,67310,0.194678799,2016
Martin,150870,131784,0.873493736,19086,0.126506264,2016
Miami-Dade,2700794,1176731,0.435698169,1524063,0.564301831,2016
Monroe,76047,35315,0.464383868,40732,0.535616132,2016
Nassau,77841,61462,0.789583895,16379,0.210416105,2016
Okaloosa,192925,110335,0.571906181,82590,0.428093819,2016
Okeechobee,40806,35254,0.863941577,5552,0.136058423,2016
Orange,1280387,813421,0.635293079,466966,0.364706921,2016
Osceola,322862,211463,0.65496404,111399,0.34503596,2016
Palm Beach,1391741,611651,0.439486226,780090,0.560513774,2016
Pasco,495868,452857,0.91326119,43011,0.08673881,2016
Pinellas,954569,275966,0.289100107,678603,0.710899893,2016
Polk,646989,399263,0.61710941,247726,0.38289059,2016
Putnam,72972,57963,0.794318369,15009,0.205681631,2016
St. Johns,220257,199337,0.905020045,20920,0.094979955,2016
St. Lucie,292826,71639,0.244646992,221187,0.755353008,2016
Santa Rosa,167009,150615,0.901837626,16394,0.098162374,2016
Sarasota,399538,254863,0.637894268,144675,0.362105732,2016
Seminole,449124,215885,0.480680169,233239,0.519319831,2016
Sumter,118577,105493,0.889658197,13084,0.110341803,2016
Suwannee,44349,36831,0.830480958,7518,0.169519042,2016
Taylor,22478,15504,0.68974108,6974,0.31025892,2016
Union,15887,13452,0.846730031,2435,0.153269969,2016
Volusia,517411,115969,0.224133233,401442,0.775866767,2016
Wakulla,31599,30848,0.976233425,751,0.023766575,2016
Walton,62943,53856,0.855631285,9087,0.144368715,2016
Washington,24888,19768,0.794278367,5120,0.205721633,2016
Alachua,254893,101621,0.398681015,153272,0.601318985,2015
Baker,27017,20152,0.745900729,6865,0.254099271,2015
Bay,173310,76398,0.440817033,96912,0.559182967,2015
Bradford,27310,20358,0.74544123,6952,0.25455877,2015
Brevard,561714,210276,0.374347088,351438,0.625652912,2015
Broward,1827367,14515,0.007943123,1812852,0.992056877,2015
Calhoun,14549,11513,0.791325864,3036,0.208674136,2015
Charlotte,167141,149466,0.894250962,17675,0.105749038,2015
Citrus,141501,131162,0.926933379,10339,0.073066621,2015
Clay,201277,183611,0.912230409,17666,0.087769591,2015
Collier,343802,307120,0.893304867,36682,0.106695133,2015
Columbia,68163,55603,0.81573581,12560,0.18426419,2015
DeSoto,34777,27167,0.781177215,7610,0.218822785,2015
Dixie,16468,14576,0.885110517,1892,0.114889483,2015
Duval,905574,0,0.0,905574,1.0,2015
Escambia,306944,252308,0.822000104,54636,0.177999896,2015
Flagler,101353,13794,0.136098586,87559,0.863901414,2015
Franklin,11840,6773,0.572043919,5067,0.427956081,2015
Gadsden,48315,30002,0.620966574,18313,0.379033426,2015
Gilchrist,16839,13906,0.825821011,2933,0.174178989,2015
Glades,12853,11205,0.871780907,1648,0.128219093,2015
Gulf,16346,10695,0.654288511,5651,0.345711489,2015
Hamilton,14630,9913,0.677580314,4717,0.322419686,2015
Hardee,27645,17947,0.649195153,9698,0.350804847,2015
Hendry,38096,25863,0.678890172,12233,0.321109828,2015
Hernando,176819,169034,0.955971926,7785,0.044028074,2015
Highlands,100748,76662,0.760928257,24086,0.239071743,2015
Hillsborough,1325563,905007,0.682734053,420556,0.317265947,2015
Holmes,19902,15834,0.795598432,4068,0.204401568,2015
Indian River,143326,94820,0.661568731,48506,0.338431269,2015
Jackson,50458,32703,0.648123192,17755,0.351876808,2015
Jefferson,14519,12061,0.830704594,2458,0.169295406,2015
Lafayette,8664,7463,0.861380425,1201,0.138619575,2015
Lake,316569,160400,0.506682587,156169,0.493317413,2015
Lee,665845,337490,0.506859705,328355,0.493140295,2015
Leon,284443,96447,0.339073206,187996,0.660926794,2015
Levy,40448,31199,0.771336036,9249,0.228663964,2015
Liberty,8698,7740,0.889859738,958,0.110140262,2015
Madison,19200,15041,0.783385417,4159,0.216614583,2015
Manatee,349334,274792,0.786616819,74542,0.213383181,2015
Marion,341205,275382,0.807086649,65823,0.192913351,2015
Martin,150062,131047,0.873285709,19015,0.126714291,2015
Miami-Dade,2653934,1160457,0.437259178,1493477,0.562740822,2015
Monroe,74206,33926,0.45718675,40280,0.54281325,2015
Nassau,76536,60349,0.788504756,16187,0.211495244,2015
Okaloosa,191898,110280,0.574680299,81618,0.425319701,2015
Okeechobee,40052,34518,0.861829621,5534,0.138170379,2015
Orange,1252396,799985,0.638763618,452411,0.361236382,2015
Osceola,308327,200419,0.650020919,107908,0.349979081,2015
Palm Beach,1378417,606274,0.439833519,772143,0.560166481,2015
Pasco,487588,445191,0.913047491,42397,0.086952509,2015
Pinellas,944971,274411,0.290390922,670560,0.709609078,2015
Polk,633052,391371,0.618228834,241681,0.381771166,2015
Putnam,72756,57876,0.795480785,14880,0.204519215,2015
St. Johns,213566,192890,0.903186837,20676,0.096813163,2015
St. Lucie,287749,70901,0.246398771,216848,0.753601229,2015
Santa Rosa,162925,147105,0.902900107,15820,0.097099893,2015
Sarasota,392090,251065,0.640324925,141025,0.359675075,2015
Seminole,442903,213465,0.481967835,229438,0.518032165,2015
Sumter,115657,103282,0.893002585,12375,0.106997415,2015
Suwannee,44452,36912,0.830378836,7540,0.169621164,2015
Taylor,22824,15808,0.692604276,7016,0.307395724,2015
Union,15918,13449,0.844892574,2469,0.155107426,2015
Volusia,510494,115656,0.226557021,394838,0.773442979,2015
Wakulla,31283,30543,0.97634498,740,0.02365502,2015
Walton,60687,51969,0.856344851,8718,0.143655149,2015
Washington,24975,19888,0.796316316,5087,0.203683684,2015
Alachua,250730,100380,0.400350975,150350,0.599649025,2014
Baker,26991,20188,0.747953021,6803,0.252046979,2014
Bay,170781,74720,0.437519396,96061,0.562480604,2014
Bradford,27323,20259,0.741463236,7064,0.258536764,2014
Brevard,552427,207313,0.375276733,345114,0.624723267,2014
Broward,1803903,14403,0.007984354,1789500,0.992015646,2014
Calhoun,14592,11528,0.79002193,3064,0.20997807,2014
Charlotte,164467,146980,0.893674719,17487,0.106325281,2014
Citrus,140798,130517,0.926980497,10281,0.073019503,2014
Clay,197403,179853,0.911095576,17550,0.088904424,2014
Collier,336783,300237,0.891485022,36546,0.108514978,2014
Columbia,67826,55263,0.814776045,12563,0.185223955,2014
DeSoto,34426,26947,0.782751409,7479,0.217248591,2014
Dixie,16356,14475,0.884996332,1881,0.115003668,2014
Duval,890066,0,0.0,890066,1.0,2014
Escambia,303907,249515,0.821024195,54392,0.178975805,2014
Flagler,99121,13484,0.136035754,85637,0.863964246,2014
Franklin,11794,6680,0.56638969,5114,0.43361031,2014
Gadsden,48096,29878,0.621215902,18218,0.378784098,2014
Gilchrist,16853,14071,0.834925533,2782,0.165074467,2014
Glades,12852,11187,0.870448179,1665,0.129551821,2014
Gulf,16543,10888,0.658163574,5655,0.341836426,2014
Hamilton,14351,9645,0.672078601,4706,0.327921399,2014
Hardee,27712,17899,0.645893476,9813,0.354106524,2014
Hendry,37895,25767,0.679957778,12128,0.320042222,2014
Hernando,174955,167263,0.956034409,7692,0.043965591,2014
Highlands,99818,77264,0.774048769,22554,0.225951231,2014
Hillsborough,1301887,887882,0.68199621,414005,0.31800379,2014
Holmes,20025,15935,0.795755306,4090,0.204244694,2014
Indian River,140955,93155,0.66088468,47800,0.33911532,2014
Jackson,50231,32258,0.642193068,17973,0.357806932,2014
Jefferson,14597,12116,0.830033569,2481,0.169966431,2014
Lafayette,8696,7497,0.862120515,1199,0.137879485,2014
Lake,309736,157950,0.509950409,151786,0.490049591,2014
Lee,653485,361890,0.553784708,291595,0.446215292,2014
Leon,281292,95508,0.339533296,185784,0.660466704,2014
Levy,40473,31301,0.773379784,9172,0.226620216,2014
Liberty,8668,7710,0.889478542,958,0.110521458,2014
Madison,19303,15107,0.782624463,4196,0.217375537,2014
Manatee,339545,266699,0.785459954,72846,0.214540046,2014
Marion,337455,272607,0.807832155,64848,0.192167845,2014
Martin,148585,129704,0.872927954,18881,0.127072046,2014
Miami-Dade,2613692,1146579,0.438681757,1467113,0.561318243,2014
Monroe,74044,33793,0.456390795,40251,0.543609205,2014
Nassau,75321,59212,0.786128702,16109,0.213871298,2014
Okaloosa,190666,109766,0.575697817,80900,0.424302183,2014
Okeechobee,39828,34245,0.859822236,5583,0.140177764,2014
Orange,1227995,786296,0.640308796,441699,0.359691204,2014
Osceola,295553,191514,0.647985302,104039,0.352014698,2014
Palm Beach,1360238,599993,0.441094132,760245,0.558905868,2014
Pasco,479340,437620,0.912963658,41720,0.087036342,2014
Pinellas,933258,272348,0.291824983,660910,0.708175017,2014
Polk,623174,385924,0.619287711,237250,0.380712289,2014
Putnam,72523,57706,0.795692401,14817,0.204307599,2014
St. Johns,207443,187002,0.901462088,20441,0.098537912,2014
St. Lucie,282821,70459,0.249129308,212362,0.750870692,2014
Santa Rosa,159785,144117,0.901943236,15668,0.098056764,2014
Sarasota,387140,248619,0.642194038,138521,0.357805962,2014
Seminole,437086,211635,0.48419533,225451,0.51580467,2014
Sumter,111125,98924,0.890204724,12201,0.109795276,2014
Suwannee,44168,36625,0.82922025,7543,0.17077975,2014
Taylor,22932,15863,0.691740799,7069,0.308259201,2014
Union,15647,13124,0.838755033,2523,0.161244967,2014
Volusia,503851,115057,0.228355208,388794,0.771644792,2014
Wakulla,31285,30555,0.976666134,730,0.023333866,2014
Walton,59793,51305,0.858043584,8488,0.141956416,2014
Washington,24959,19880,0.79650627,5079,0.20349373,2014
Alachua,248002,99282,0.400327417,148720,0.599672583,2013
Baker,26881,20088,0.747293627,6793,0.252706373,2013
Bay,169866,74517,0.438681078,95349,0.561318922,2013
Bradford,27217,20130,0.739611272,7087,0.260388728,2013
Brevard,548424,206365,0.376287325,342059,0.623712675,2013
Broward,1784715,14699,0.008236049,1770016,0.991763951,2013
Calhoun,14621,11554,0.790233226,3067,0.209766774,2013
Charlotte,163679,146592,0.895606645,17087,0.104393355,2013
Citrus,140519,130277,0.927113059,10242,0.072886941,2013
Clay,192843,175387,0.909480769,17456,0.090519231,2013
Collier,333663,297103,0.890428366,36560,0.109571634,2013
Columbia,67489,55000,0.814947621,12489,0.185052379,2013
DeSoto,34367,26827,0.780603486,7540,0.219396514,2013
Dixie,16263,14385,0.884523151,1878,0.115476849,2013
Duval,876075,0,0.0,876075,1.0,2013
Escambia,301120,247278,0.821194208,53842,0.178805792,2013
Flagler,97843,13301,0.135942275,84542,0.864057725,2013
Franklin,11562,6501,0.562272963,5061,0.437727037,2013
Gadsden,47588,29474,0.619357821,18114,0.380642179,2013
Gilchrist,16880,14213,0.84200237,2667,0.15799763,2013
Glades,12658,10967,0.866408595,1691,0.133591405,2013
Gulf,16106,10623,0.659567863,5483,0.340432137,2013
Hamilton,14507,9863,0.679878679,4644,0.320121321,2013
Hardee,27682,17941,0.648110686,9741,0.351889314,2013
Hendry,37808,25888,0.68472281,11920,0.31527719,2013
Hernando,173808,166160,0.955997422,7648,0.044002578,2013
Highlands,99092,77026,0.777318048,22066,0.222681952,2013
Hillsborough,1276410,869181,0.680957529,407229,0.319042471,2013
Holmes,20022,15913,0.794775747,4109,0.205224253,2013
Indian River,139586,92382,0.66182855,47204,0.33817145,2013
Jackson,50166,32082,0.639516804,18084,0.360483196,2013
Jefferson,14554,12086,0.830424626,2468,0.169575374,2013
Lafayette,8618,7402,0.858899977,1216,0.141100023,2013
Lake,303317,155998,0.514306814,147319,0.485693186,2013
Lee,643367,357168,0.555154368,286199,0.444845632,2013
Leon,278377,94650,0.340006538,183727,0.659993462,2013
Levy,40304,31053,0.770469432,9251,0.229530568,2013
Liberty,8483,7489,0.882824472,994,0.117175528,2013
Madison,19395,15144,0.780819799,4251,0.219180201,2013
Manatee,333880,261682,0.783760633,72198,0.216239367,2013
Marion,335008,270338,0.806959834,64670,0.193040166,2013
Martin,148077,129133,0.87206656,18944,0.12793344,2013
Miami-Dade,2582375,1137821,0.440610291,1444554,0.559389709,2013
Monroe,73560,33380,0.453779228,40180,0.546220772,2013
Nassau,74661,58632,0.785309599,16029,0.214690401,2013
Okaloosa,188349,108531,0.576222863,79818,0.423777137,2013
Okeechobee,39762,34212,0.860419496,5550,0.139580504,2013
Orange,1202978,772657,0.642286891,430321,0.357713109,2013
Osceola,288361,185825,0.644417934,102536,0.355582066,2013
Palm Beach,1345652,596187,0.443046939,749465,0.556953061,2013
Pasco,473566,432770,0.913853613,40796,0.086146387,2013
Pinellas,926610,271227,0.292708907,655383,0.707291093,2013
Polk,613950,381496,0.621379591,232454,0.378620409,2013
Putnam,72605,57902,0.797493286,14703,0.202506714,2013
St. Johns,201541,181302,0.899578746,20239,0.100421254,2013
St. Lucie,281151,70920,0.252248792,210231,0.747751208,2013
Santa Rosa,157317,141769,0.901167706,15548,0.098832294,2013
Sarasota,385292,247767,0.643062924,137525,0.356937076,2013
Seminole,431074,210222,0.48767033,220852,0.51232967,2013
Sumter,105104,93122,0.88599863,11982,0.11400137,2013
Suwannee,43873,36379,0.829188795,7494,0.170811205,2013
Taylor,23018,15987,0.694543401,7031,0.305456599,2013
Union,15483,12976,0.838080475,2507,0.161919525,2013
Volusia,498978,115300,0.231072312,383678,0.768927688,2013
Wakulla,30869,30134,0.976189705,735,0.023810295,2013
Walton,57779,49537,0.857353018,8242,0.142646982,2013
Washington,24793,19646,0.792401081,5147,0.207598919,2013
Alachua *,246770,98850,0.400575435,147920,0.599424565,2012
Baker,26938,20155,0.748199569,6783,0.251800431,2012
Bay,169392,74417,0.439318268,94975,0.560681732,2012
Bradford,27239,20264,0.743933331,6975,0.256066669,2012
Brevard,545625,205690,0.376980527,339935,0.623019473,2012
Broward *,1771099,16607,0.009376664,1754492,0.990623336,2012
Calhoun,14641,11598,0.792159006,3043,0.207840994,2012
Charlotte,163357,146373,0.896031391,16984,0.103968609,2012
Citrus,140761,130490,0.927032346,10271,0.072967654,2012
Clay,192071,174677,0.909439738,17394,0.090560262,2012
Collier,329849,293343,0.889325115,36506,0.110674885,2012
Columbia,67729,55102,0.813565829,12627,0.186434171,2012
DeSoto,34408,26823,0.77955708,7585,0.22044292,2012
Dixie,16298,14423,0.884955209,1875,0.115044791,2012
Duval,869729,0,0.0,869729,1.0,2012
Escambia,299511,245796,0.820657672,53715,0.179342328,2012
Flagler,97160,13253,0.13640387,83907,0.86359613,2012
Franklin,11530,6431,0.557762359,5099,0.442237641,2012
Gadsden,47506,29595,0.62297394,17911,0.37702606,2012
Gilchrist,16946,14289,0.843207837,2657,0.156792163,2012
Glades,12671,11005,0.868518665,1666,0.131481335,2012
Gulf,15907,10458,0.657446407,5449,0.342553593,2012
Hamilton,14836,10190,0.686842815,4646,0.313157185,2012
Hardee,27762,17950,0.64656725,9812,0.35343275,2012
Hendry,38132,26288,0.689394734,11844,0.310605266,2012
Hernando,173104,165397,0.955477632,7707,0.044522368,2012
Highlands,98955,77041,0.778545804,21914,0.221454196,2012
Hillsborough,1256118,854465,0.680242621,401653,0.319757379,2012
Holmes,19984,15868,0.794035228,4116,0.205964772,2012
Indian River,139446,92378,0.662464323,47068,0.337535677,2012
Jackson,49847,32138,0.644732883,17709,0.355267117,2012
Jefferson,14478,12034,0.831192154,2444,0.168807846,2012
Lafayette,8663,7441,0.858940321,1222,0.141059679,2012
Lake,299677,154655,0.516072305,145022,0.483927695,2012
Lee *,638029,353196,0.553573584,284833,0.446426416,2012
Leon,277670,94027,0.338628588,183643,0.661371412,2012
Levy,40339,31080,0.770470265,9259,0.229529735,2012
Liberty,8519,7524,0.883202254,995,0.116797746,2012
Madison *,19227,15005,0.780412961,4222,0.219587039,2012
Manatee,330302,258211,0.781742163,72091,0.218257837,2012
Marion,332989,268686,0.806891519,64303,0.193108481,2012
Martin,147203,128332,0.871802884,18871,0.128197116,2012
Miami-Dade,2551290,1121297,0.439501977,1429993,0.560498023,2012
Monroe,72897,32776,0.449620698,40121,0.550379302,2012
Nassau,73745,57997,0.786453319,15748,0.213546681,2012
Okaloosa,187280,107903,0.576158693,79377,0.423841307,2012
Okeechobee,39805,34227,0.859866851,5578,0.140133149,2012
Orange,1175941,754470,0.641588311,421471,0.358411689,2012
Osceola,280866,180821,0.64379811,100045,0.35620189,2012
Palm Beach,1335415,592927,0.444002052,742488,0.555997948,2012
Pasco,468562,428319,0.914113821,40243,0.085886179,2012
Pinellas,920381,270109,0.293475202,650272,0.706524798,2012
Polk,606888,378315,0.623368727,228573,0.376631273,2012
Putnam,73158,58453,0.798996692,14705,0.201003308,2012
St. Johns,196071,176128,0.898286845,19943,0.101713155,2012
St. Lucie,280355,70872,0.252793779,209483,0.747206221,2012
Santa Rosa,155390,139935,0.900540575,15455,0.099459425,2012
Sarasota,383664,247070,0.643974936,136594,0.356025064,2012
Seminole,428104,209974,0.490474277,218130,0.509525723,2012
Sumter,100198,88363,0.88188387,11835,0.11811613,2012
Suwannee,43796,36265,0.828043657,7531,0.171956343,2012
Taylor,22898,15861,0.692680583,7037,0.307319417,2012
Union,15510,12971,0.836299162,2539,0.163700838,2012
Volusia,497145,115757,0.232843537,381388,0.767156463,2012
Wakulla,30771,30037,0.976146372,734,0.023853628,2012
Walton,56965,48818,0.856982358,8147,0.143017642,2012
Washington,24922,19730,0.79167001,5192,0.20832999,2012
Alachua *,247337,98928,0.399972507,148409,0.600027493,2011
Baker,26927,20147,0.748208118,6780,0.251791882,2011
Bay *,169278,74357,0.439259679,94921,0.560740321,2011
Bradford,28662,21677,0.756297537,6985,0.243702463,2011
Brevard *,545184,206763,0.37925361,338421,0.62074639,2011
Broward *,1753162,16917,0.009649422,1736245,0.990350578,2011
Calhoun,14685,11639,0.79257746,3046,0.20742254,2011
Charlotte,160463,143722,0.895670653,16741,0.104329347,2011
Citrus,140956,130646,0.926856608,10310,0.073143392,2011
Clay,191143,173754,0.909026226,17389,0.090973774,2011
Collier,323785,287485,0.887888568,36300,0.112111432,2011
Columbia,67528,54911,0.813158986,12617,0.186841014,2011
DeSoto,34708,27116,0.781260804,7592,0.218739196,2011
Dixie,16385,14489,0.884284406,1896,0.115715594,2011
Duval,864601,0,0.0,864601,1.0,2011
Escambia,299261,245632,0.820795226,53629,0.179204774,2011
Flagler,96241,13127,0.13639717,83114,0.86360283,2011
Franklin,11527,6551,0.568317862,4976,0.431682138,2011
Gadsden,48200,29645,0.615041494,18555,0.384958506,2011
Gilchrist,16983,14288,0.8413119,2695,0.1586881,2011
Glades,12812,11175,0.87222916,1637,0.12777084,2011
Gulf,15789,10360,0.656153018,5429,0.343846982,2011
Hamilton,14744,10208,0.69234943,4536,0.30765057,2011
Hardee,27653,17964,0.649622102,9689,0.350377898,2011
Hendry,38908,27119,0.697003187,11789,0.302996813,2011
Hernando,173078,165355,0.9553785,7723,0.0446215,2011
Highlands,98712,77132,0.781384229,21580,0.218615771,2011
Hillsborough,1238951,842395,0.679926002,396556,0.320073998,2011
Holmes,19901,15694,0.788603588,4207,0.211396412,2011
Indian River,138694,91899,0.662602564,46795,0.337397436,2011
Jackson,49964,33974,0.679969578,15990,0.320030422,2011
Jefferson,14666,12210,0.832537843,2456,0.167462157,2011
Lafayette,8752,7527,0.860031993,1225,0.139968007,2011
Lake,298265,154387,0.517616884,143878,0.482383116,2011
Lee *,625310,348297,0.556998929,277013,0.443001071,2011
Leon,276278,93796,0.339498621,182482,0.660501379,2011
Levy,40767,31499,0.772659259,9268,0.227340741,2011
Liberty,8370,7370,0.880525687,1000,0.119474313,2011
Madison *,19298,15050,0.779873562,4248,0.220126438,2011
Manatee,325905,254556,0.781074239,71349,0.218925761,2011
Marion,331745,267939,0.807665526,63806,0.192334474,2011
Martin,146689,127916,0.87202176,18773,0.12797824,2011
Miami-Dade *,2516537,1109057,0.440707607,1407480,0.559292393,2011
Monroe,72670,32603,0.448644558,40067,0.551355442,2011
Nassau,73684,57954,0.786520819,15730,0.213479181,2011
Okaloosa,181679,104982,0.577843339,76697,0.422156661,2011
Okeechobee,39870,34289,0.860020065,5581,0.139979935,2011
Orange,1157342,742671,0.641704008,414671,0.358295992,2011
Osceola,273867,177648,0.648665228,96219,0.351334772,2011
Palm Beach *,1325758,590046,0.445063126,735712,0.554936874,2011
Pasco,466533,426604,0.914413343,39929,0.085586657,2011
Pinellas,918496,270559,0.294567423,647937,0.705432577,2011
Polk *,604792,377425,0.624057527,227367,0.375942473,2011
Putnam,74052,58967,0.796291795,15085,0.203708205,2011
St. Johns,192852,172963,0.896869102,19889,0.103130898,2011
St. Lucie,279696,71256,0.254762313,208440,0.745237687,2011
Santa Rosa,154901,139499,0.90056875,15402,0.09943125,2011
Sarasota,381319,246073,0.645320585,135246,0.354679415,2011
Seminole,424587,208627,0.49136455,215960,0.50863545,2011
Sumter,96615,84815,0.877865756,11800,0.122134244,2011
Suwannee,43215,35652,0.824991322,7563,0.175008678,2011
Taylor,22500,15523,0.689911111,6977,0.310088889,2011
Union,15473,12935,0.835972339,2538,0.164027661,2011
Volusia,495400,115830,0.233811062,379570,0.766188938,2011
Wakulla,30877,30131,0.975839622,746,0.024160378,2011
Walton,55450,47808,0.862182146,7642,0.137817854,2011
Washington,24638,19255,0.781516357,5383,0.218483643,2011
Alachua,247336,98991,0.400228839,148345,0.599771161,2010
Baker,27115,20304,0.748810621,6811,0.251189379,2010
Bay,168852,74139,0.439076825,94713,0.560923175,2010
Bradford,28520,21503,0.753962132,7017,0.246037868,2010
Brevard,543376,206332,0.379722329,337044,0.620277671,2010
Broward,1748066,17088,0.009775375,1730978,0.990224625,2010
Calhoun,14625,11575,0.791452991,3050,0.208547009,2010
Charlotte,159978,143337,0.895979447,16641,0.104020553,2010
Citrus,141236,130918,0.926944972,10318,0.073055028,2010
Clay,190865,173446,0.908736542,17419,0.091263458,2010
Collier,321520,285170,0.886943269,36350,0.113056731,2010
Columbia,67531,54918,0.813226518,12613,0.186773482,2010
DeSoto,34862,27225,0.780936263,7637,0.219063737,2010
Dixie,16422,14525,0.884484228,1897,0.115515772,2010
Duval,864263,0,0.0,864263,1.0,2010
Escambia,297619,243998,0.819833411,53621,0.180166589,2010
Flagler,95696,13062,0.136494733,82634,0.863505267,2010
Franklin,11549,6540,0.566282795,5009,0.433717205,2010
Gadsden,46389,27945,0.602405743,18444,0.397594257,2010
Gilchrist,16939,14206,0.838656355,2733,0.161343645,2010
Glades,12884,11204,0.869605713,1680,0.130394287,2010
Gulf,15863,10437,0.657946164,5426,0.342053836,2010
Hamilton,14799,8598,0.580985202,6201,0.419014798,2010
Hardee,27731,17973,0.648119433,9758,0.351880567,2010
Hendry,39140,27345,0.698645887,11795,0.301354113,2010
Hernando,172778,165047,0.95525472,7731,0.04474528,2010
Highlands,98786,77236,0.781851679,21550,0.218148321,2010
Hillsborough,1229226,834255,0.678683171,394971,0.321316829,2010
Holmes,19927,15672,0.786470618,4255,0.213529382,2010
Indian River,138028,91363,0.661916423,46665,0.338083577,2010
Jackson,49746,33828,0.680014474,15918,0.319985526,2010
Jefferson,14761,12255,0.830228304,2506,0.169771696,2010
Lafayette,8870,7633,0.86054115,1237,0.13945885,2010
Lake,297047,154245,0.519261262,142802,0.480738738,2010
Lee,618754,345548,0.558457804,273206,0.441542196,2010
Leon,275487,94111,0.341616846,181376,0.658383154,2010
Levy,40801,31526,0.77267714,9275,0.22732286,2010
Liberty,8365,7369,0.880932457,996,0.119067543,2010
Madison,19224,14980,0.77923429,4244,0.22076571,2010
Manatee,322833,251773,0.779886195,71060,0.220113805,2010
Marion,331303,267805,0.80833859,63498,0.19166141,2010
Martin,146318,127557,0.871779275,18761,0.128220725,2010
Miami-Dade,2496457,1109424,0.444399403,1387033,0.555600597,2010
Monroe,73090,33044,0.45210015,40046,0.54789985,2010
Nassau,73314,57618,0.785907194,15696,0.214092806,2010
Okaloosa,180822,104759,0.579348752,76063,0.420651248,2010
Okeechobee,39996,34375,0.859460946,5621,0.140539054,2010
Orange,1145956,736657,0.642831836,409299,0.357168164,2010
Osceola,268685,173820,0.646928559,94865,0.353071441,2010
Palm Beach,1320134,587432,0.44497907,732702,0.55502093,2010
Pasco,464697,424912,0.914385072,39785,0.085614928,2010
Pinellas,916542,270494,0.295124501,646048,0.704875499,2010
Polk,602095,375622,0.623858361,226473,0.376141639,2010
Putnam,74364,59213,0.796258942,15151,0.203741058,2010
Santa Rosa,151372,136250,0.900100415,15122,0.099899585,2010
Sarasota,379448,244936,0.645506104,134512,0.354493896,2010
Seminole,422718,207308,0.490416779,215410,0.509583221,2010
St. Johns,190039,170308,0.896173943,19731,0.103826057,2010
St. Lucie,277789,71006,0.255611273,206783,0.744388727,2010
Sumter,93420,81817,0.875797474,11603,0.124202526,2010
Suwannee,41551,33989,0.818006787,7562,0.181993213,2010
Taylor,22570,15553,0.689100576,7017,0.310899424,2010
Union,15535,12976,0.835275185,2559,0.164724815,2010
Volusia,494593,116655,0.235860596,377938,0.764139404,2010
Wakulla,30776,30026,0.975630361,750,0.024369639,2010
Walton,55043,47435,0.86178079,7608,0.13821921,2010
Washington,24896,19540,0.784865039,5356,0.215134961,2010
Alachua,256232,107260,0.418605014,148972,0.581394986,2009
Baker,25899,19487,0.752422873,6412,0.247577127,2009
Bay,169562,72558,0.427914273,97004,0.572085727,2009
Bradford,29085,21701,0.746123431,7384,0.253876569,2009
Brevard,555657,212749,0.382878286,342908,0.617121714,2009
Broward,1744922,12955,0.007424401,1731967,0.992575599,2009
Calhoun,14601,11580,0.793096363,3021,0.206903637,2009
Charlotte,165455,148466,0.897319513,16989,0.102680487,2009
Citrus,142609,131763,0.923945894,10846,0.076054106,2009
Clay,185208,167545,0.904631549,17663,0.095368451,2009
Collier,333032,293909,0.882524802,39123,0.117475198,2009
Columbia,66409,54750,0.824436447,11659,0.175563553,2009
DeSoto,34792,28053,0.806306047,6739,0.193693953,2009
Dixie,16221,14243,0.878059306,1978,0.121940694,2009
Duval,900518,0,0.0,900518,1.0,2009
Escambia,312980,256463,0.819422966,56517,0.180577034,2009
Flagler,94901,12141,0.12793332,82760,0.87206668,2009
Franklin,12414,8577,0.690913485,3837,0.309086515,2009
Gadsden,50046,33516,0.669703872,16530,0.330296128,2009
Gilchrist,17393,14929,0.858333812,2464,0.141666188,2009
Glades,11311,9656,0.853682256,1655,0.146317744,2009
Gulf,16798,11322,0.674008811,5476,0.325991189,2009
Hamilton,14783,11504,0.778191166,3279,0.221808834,2009
Hardee,28333,18996,0.670454947,9337,0.329545053,2009
Hendry,41320,29733,0.719578896,11587,0.280421104,2009
Hernando,165048,157408,0.953710436,7640,0.046289564,2009
Highlands,99713,78851,0.790779537,20862,0.209220463,2009
Hillsborough,1196892,800116,0.668494735,396776,0.331505265,2009
Holmes,19857,15748,0.793070454,4109,0.206929546,2009
Indian River,141634,91606,0.646779728,50028,0.353220272,2009
Jackson,52637,34086,0.647567301,18551,0.352432699,2009
Jefferson,14677,12156,0.828234653,2521,0.171765347,2009
Lafayette,8183,7185,0.878039839,998,0.121960161,2009
Lake,291993,158729,0.543605497,133264,0.456394503,2009
Lee,615124,323780,0.526365416,291344,0.473634584,2009
Leon,274803,96924,0.352703573,177879,0.647296427,2009
Levy,40674,30730,0.755519496,9944,0.244480504,2009
Liberty,8220,7230,0.879562044,990,0.120437956,2009
Madison,20333,15870,0.780504598,4463,0.219495402,2009
Manatee,318404,238835,0.750100501,79569,0.249899499,2009
Marion,330440,268855,0.813627285,61585,0.186372715,2009
Martin,143856,124191,0.863300801,19665,0.136699199,2009
Miami-Dade,2472344,1081422,0.437407578,1390922,0.562592422,2009
Monroe,77925,36268,0.46542188,41657,0.53457812,2009
Nassau,72588,56400,0.776987932,16188,0.223012068,2009
Okaloosa,196237,117119,0.596824248,79118,0.403175752,2009
Okeechobee,39703,34326,0.864569428,5377,0.135430572,2009
Orange,1108882,710458,0.640697567,398424,0.359302433,2009
Osceola,272788,178908,0.655849964,93880,0.344150036,2009
Palm Beach,1287344,558970,0.434204067,728374,0.565795933,2009
Pasco,439786,398443,0.905992915,41343,0.094007085,2009
Pinellas,931113,271478,0.291562893,659635,0.708437107,2009
Polk,584343,363807,0.622591526,220536,0.377408474,2009
Putnam,74608,58673,0.786417006,15935,0.213582994,2009
St. Johns,183572,163044,0.888174667,20528,0.111825333,2009
St. Lucie,272864,72725,0.266524716,200139,0.733475284,2009
Santa Rosa,144508,130194,0.90094666,14314,0.09905334,2009
Sarasota,389320,253525,0.651199527,135795,0.348800473,2009
Seminole,423759,206308,0.486852197,217451,0.513147803,2009
Sumter,95326,85788,0.899943352,9538,0.100056648,2009
Suwannee,40230,32857,0.816728809,7373,0.183271191,2009
Taylor,23164,16349,0.705793473,6815,0.294206527,2009
Union,15576,12943,0.830957884,2633,0.169042116,2009
Volusia,507105,116448,0.229632916,390657,0.770367084,2009
Wakulla,31791,31050,0.976691516,741,0.023308484,2009
Walton,57917,50544,0.872697136,7373,0.127302864,2009
Washington,24721,19500,0.788803042,5221,0.211196958,2009
Alachua,252388,105051,0.416228188,147337,0.583771812,2008
Baker,25890,19564,0.755658555,6326,0.244341445,2008
Bay,169307,66539,0.393007968,102768,0.606992032,2008
Bradford,29059,21509,0.740183764,7550,0.259816236,2008
Brevard,556213,212492,0.382033502,343721,0.617966498,2008
Broward,1758494,12750,0.007250522,1745744,0.992749478,2008
Calhoun,14310,11302,0.789797345,3008,0.210202655,2008
Charlotte,165781,148130,0.893528209,17651,0.106471791,2008
Citrus,142043,131095,0.922924748,10948,0.077075252,2008
Clay,185168,167484,0.904497537,17684,0.095502463,2008
Collier,332854,292794,0.879646932,40060,0.120353068,2008
Columbia,66121,54304,0.821282195,11817,0.178717805,2008
DeSoto,34487,27860,0.807840636,6627,0.192159364,2008
Dixie,15963,13909,0.871327445,2054,0.128672555,2008
Duval,904971,0,0.0,904971,1.0,2008
Escambia,313480,256911,0.819545107,56569,0.180454893,2008
Flagler,95512,12304,0.128821509,83208,0.871178491,2008
Franklin,12331,8505,0.689725083,3826,0.310274917,2008
Gadsden,50611,33544,0.662780818,17067,0.337219182,2008
Gilchrist,17256,14718,0.852920723,2538,0.147079277,2008
Glades,11323,9668,0.853837322,1655,0.146162678,2008
Gulf,16923,11444,0.676239437,5479,0.323760563,2008
Hamilton,14779,11494,0.777725151,3285,0.222274849,2008
Hardee,27909,18620,0.667168297,9289,0.332831703,2008
Hendry,41216,29765,0.722171002,11451,0.277828998,2008
Hernando,164907,157260,0.953628409,7647,0.046371591,2008
Highlands,100207,79150,0.789864979,21057,0.210135021,2008
Hillsborough,1200541,803794,0.669526488,396747,0.330473512,2008
Holmes,19757,15633,0.791263856,4124,0.208736144,2008
Indian River,141667,91612,0.64667142,50055,0.35332858,2008
Jackson,52639,33973,0.645395999,18666,0.354604001,2008
Jefferson,14553,12016,0.825671683,2537,0.174328317,2008
Lafayette,8287,7278,0.878243031,1009,0.121756969,2008
Lake,288379,157380,0.545740154,130999,0.454259846,2008
Lee,623725,329279,0.527923364,294446,0.472076636,2008
Leon,274892,97040,0.353011364,177852,0.646988636,2008
Levy,40817,30650,0.75091261,10167,0.24908739,2008
Liberty,8158,7207,0.883427311,951,0.116572689,2008
Madison,20152,15814,0.784736006,4338,0.215263994,2008
Manatee,317699,237929,0.74891328,79770,0.25108672,2008
Marion,329418,267915,0.813297998,61503,0.186702002,2008
Martin,143868,124205,0.863326104,19663,0.136673896,2008
Miami-Dade,2477289,1088714,0.439477994,1388575,0.560522006,2008
Monroe,76081,34788,0.45724951,41293,0.54275049,2008
Nassau,71915,55865,0.776819857,16050,0.223180143,2008
Okaloosa,197597,117526,0.594776236,80071,0.405223764,2008
Okeechobee,40003,34507,0.862610304,5496,0.137389696,2008
Orange,1114979,715627,0.641830025,399352,0.358169975,2008
Osceola,273709,179424,0.655528317,94285,0.344471683,2008
Palm Beach,1294654,562807,0.434716148,731847,0.565283852,2008
Pasco,438668,397069,0.905169741,41599,0.094830259,2008
Pinellas,938461,273608,0.291549675,664853,0.708450325,2008
Polk,585733,365265,0.623603246,220468,0.376396754,2008
Putnam,74989,58901,0.785461868,16088,0.214538132,2008
St. Johns,181180,160414,0.8853847,20766,0.1146153,2008
St. Lucie,276585,73815,0.266879983,202770,0.733120017,2008
Santa Rosa,144136,129859,0.900947716,14277,0.099052284,2008
Sarasota,393608,254891,0.647575761,138717,0.352424239,2008
Seminole,426413,206899,0.485208003,219514,0.514791997,2008
Sumter,93034,83445,0.896930155,9589,0.103069845,2008
Suwannee,40927,33503,0.818603856,7424,0.181396144,2008
Taylor,23199,16367,0.705504548,6832,0.294495452,2008
Union,15974,13337,0.834919244,2637,0.165080756,2008
Volusia,510750,117584,0.230218306,393166,0.769781694,2008
Wakulla,30717,29970,0.975681219,747,0.024318781,2008
Walton,57784,50370,0.871694587,7414,0.128305413,2008
Washington,24779,19341,0.780539973,5438,0.219460027,2008
Alachua,247561,103217,0.416935624,144344,0.583064376,2007
Baker,25623,19348,0.755102837,6275,0.244897163,2007
Bay,167631,66728,0.398064797,100903,0.601935203,2007
Bradford,29055,21463,0.738702461,7592,0.261297539,2007
Brevard,552109,210967,0.382111141,341142,0.617888859,2007
Broward,1765707,14080,0.007974143,1751627,0.992025857,2007
Calhoun,14477,11436,0.789942668,3041,0.210057332,2007
Charlotte,164584,147140,0.894011569,17444,0.105988431,2007
Citrus,140124,129101,0.921333961,11023,0.078666039,2007
Clay,184644,167005,0.904470224,17639,0.095529776,2007
Collier,333858,294289,0.881479551,39569,0.118520449,2007
Columbia,65373,53514,0.818594833,11859,0.181405167,2007
DeSoto,33983,27366,0.805284995,6617,0.194715005,2007
Dixie,15808,13755,0.870129049,2053,0.129870951,2007
Duval,897597,0,0.0,897597,1.0,2007
Escambia,311775,255081,0.818157325,56694,0.181842675,2007
Flagler,93568,14879,0.15901804,78689,0.84098196,2007
Franklin,12249,8426,0.687892889,3823,0.312107111,2007
Gadsden,49398,32345,0.654783594,17053,0.345216406,2007
Gilchrist,17106,14614,0.854320122,2492,0.145679878,2007
Glades,11055,9419,0.852012664,1636,0.147987336,2007
Gulf,16815,11286,0.671186441,5529,0.328813559,2007
Hamilton,14705,11436,0.777694662,3269,0.222305338,2007
Hardee,27520,18383,0.667986919,9137,0.332013081,2007
Hendry,39651,28414,0.716602356,11237,0.283397644,2007
Hernando,162193,154876,0.954887079,7317,0.045112921,2007
Highlands,98727,77642,0.78643127,21085,0.21356873,2007
Hillsborough,1192861,799294,0.67006466,393567,0.32993534,2007
Holmes,19464,15358,0.789046445,4106,0.210953555,2007
Indian River,139757,90607,0.648318152,49150,0.351681848,2007
Jackson,50416,33360,0.6616947,17056,0.3383053,2007
Jefferson,14494,11940,0.823789154,2554,0.176210846,2007
Lafayette,8215,7202,0.876688984,1013,0.123311016,2007
Lake,286499,156327,0.545645884,130172,0.454354116,2007
Lee,615741,324885,0.52763256,290856,0.47236744,2007
Leon,272896,96467,0.353493639,176429,0.646506361,2007
Levy,40045,29846,0.745311525,10199,0.254688475,2007
Liberty,7772,6822,0.877766341,950,0.122233659,2007
Madison,19944,15632,0.783794625,4312,0.216205375,2007
Manatee,315890,236109,0.747440565,79781,0.252559435,2007
Marion,325023,263792,0.811610255,61231,0.188389745,2007
Martin,143737,124094,0.863340685,19643,0.136659315,2007
Miami-Dade,2462292,1095100,0.444748226,1367192,0.555251774,2007
Monroe,78987,35749,0.452593465,43238,0.547406535,2007
Nassau,69569,53520,0.769308169,16049,0.230691831,2007
Okaloosa,196540,116299,0.591731963,80241,0.408268037,2007
Okeechobee,39030,33216,0.851037663,5814,0.148962337,2007
Orange,1105603,713851,0.645666663,391752,0.354333337,2007
Osceola,266123,174453,0.655535222,91670,0.344464778,2007
Palm Beach,1295033,562781,0.434568849,732252,0.565431151,2007
Pasco,434425,392598,0.903718709,41827,0.096281291,2007
Pinellas,944199,276363,0.292695714,667836,0.707304286,2007
Polk,581058,362801,0.62438001,218257,0.37561999,2007
Putnam,74799,58676,0.78444899,16123,0.21555101,2007
St. Johns,173935,153306,0.881398223,20629,0.118601777,2007
St. Lucie,271961,74039,0.27224124,197922,0.72775876,2007
Santa Rosa,142144,128050,0.900847028,14094,0.099152972,2007
Sarasota,387461,250858,0.647440646,136603,0.352559354,2007
Seminole,425698,208419,0.489593562,217279,0.510406438,2007
Sumter,89771,80202,0.893406557,9569,0.106593443,2007
Suwannee,39608,32053,0.809255706,7555,0.190744294,2007
Taylor,22516,15720,0.69817019,6796,0.30182981,2007
Union,15722,13013,0.827693678,2709,0.172306322,2007
Volusia,508014,116542,0.229407064,391472,0.770592936,2007
Wakulla,29417,28676,0.974810484,741,0.025189516,2007
Walton,57093,49420,0.865605241,7673,0.134394759,2007
Washington,23719,18222,0.768244867,5497,0.231755133,2007
Alachua,243779,101950,0.418206654,141829,0.581793346,2006
Baker,25004,19105,0.764077748,5899,0.235922252,2006
Bay,165515,65551,0.396042655,99964,0.603957345,2006
Bradford,28551,21051,0.737312178,7500,0.262687822,2006
Brevard,543050,213667,0.393457324,329383,0.606542676,2006
Broward,1753162,27773,0.015841662,1725389,0.984158338,2006
Calhoun,14113,11075,0.784737476,3038,0.215262524,2006
Charlotte,160315,143363,0.894258179,16952,0.105741821,2006
Citrus,136749,125772,0.919728846,10977,0.080271154,2006
Clay,176901,159442,0.90130638,17459,0.09869362,2006
Collier,326658,287442,0.879947835,39216,0.120052165,2006
Columbia,63538,52156,0.820863106,11382,0.179136894,2006
DeSoto,33164,26409,0.796315282,6755,0.203684718,2006
Dixie,15677,13635,0.869745487,2042,0.130254513,2006
Duval,879235,0,0.0,879235,1.0,2006
Escambia,309647,252859,0.816604069,56788,0.183395931,2006
Flagler,89075,12751,0.143149032,76324,0.856850968,2006
Franklin,11916,8127,0.682024169,3789,0.317975831,2006
Gadsden,48195,31222,0.647826538,16973,0.352173462,2006
Gilchrist,16703,14220,0.85134407,2483,0.14865593,2006
Glades,10796,9170,0.849388662,1626,0.150611338,2006
Gulf,16509,10769,0.652310861,5740,0.347689139,2006
Hamilton,14517,11233,0.773782462,3284,0.226217538,2006
Hardee,27186,18097,0.665673508,9089,0.334326492,2006
Hendry,38678,27534,0.711877553,11144,0.288122447,2006
Hernando,157006,149676,0.953313886,7330,0.046686114,2006
Highlands,96672,75900,0.785129096,20772,0.214870904,2006
Hillsborough,1164425,777670,0.667857526,386755,0.332142474,2006
Holmes,19502,15475,0.793508358,4027,0.206491642,2006
Indian River,135262,86779,0.641562301,48483,0.358437699,2006
Jackson,50246,33191,0.660569996,17055,0.339430004,2006
Jefferson,14353,11833,0.824426949,2520,0.175573051,2006
Lafayette,8060,7035,0.872828784,1025,0.127171216,2006
Lake,276783,151734,0.548205634,125049,0.451794366,2006
Lee,585608,308667,0.527088086,276941,0.472911914,2006
Leon,272497,96161,0.352888289,176336,0.647111711,2006
Levy,38981,29142,0.747594982,9839,0.252405018,2006
Liberty,7772,6815,0.876865672,957,0.123134328,2006
Madison,19814,15476,0.781063894,4338,0.218936106,2006
Manatee,308325,228622,0.741496797,79703,0.258503203,2006
Marion,315074,256386,0.813732647,58688,0.186267353,2006
Martin,142645,122940,0.861859862,19705,0.138140138,2006
Miami-Dade,2437022,1098924,0.450929044,1338098,0.549070956,2006
Monroe,80510,36466,0.452937523,44044,0.547062477,2006
Nassau,68188,52064,0.763536106,16124,0.236463894,2006
Okaloosa,192672,114483,0.594185974,78189,0.405814026,2006
Okeechobee,38666,32993,0.853281953,5673,0.146718047,2006
Orange,1079524,697666,0.646271875,381858,0.353728125,2006
Osceola,255903,165627,0.647225707,90276,0.352774293,2006
Palm Beach,1287987,561330,0.435819616,726657,0.564180384,2006
Pasco,424355,382872,0.902244583,41483,0.097755417,2006
Pinellas,948102,280487,0.295840532,667615,0.704159468,2006
Polk,565049,354143,0.626747415,210906,0.373252585,2006
Putnam,74416,58317,0.783662116,16099,0.216337884,2006
St. Johns,165291,145025,0.877391994,20266,0.122608006,2006
St. Lucie,259315,73432,0.283176831,185883,0.716823169,2006
Santa Rosa,141428,127411,0.900889499,14017,0.099110501,2006
Sarasota,379386,249601,0.657907777,129785,0.342092223,2006
Seminole,420667,207594,0.493487723,213073,0.506512277,2006
Sumter,82599,73393,0.888545866,9206,0.111454134,2006
Suwannee,38799,31454,0.810690997,7345,0.189309003,2006
Taylor,21471,14632,0.681477342,6839,0.318522658,2006
Union,15028,12366,0.822863987,2662,0.177136013,2006
Volusia,503844,115720,0.229674264,388124,0.770325736,2006
Wakulla,28393,27663,0.974289438,730,0.025710562,2006
Walton,55786,48034,0.861040404,7752,0.138959596,2006
Washington,23073,17571,0.761539462,5502,0.238460538,2006
Alachua,240764,100507,0.417450283,140257,0.582549717,2005
Baker,23953,18270,0.762743706,5683,0.237256294,2005
Bay,161721,64186,0.396893415,97535,0.603106585,2005
Bradford,28118,20847,0.741411196,7271,0.258588804,2005
Brevard,531970,210260,0.395247852,321710,0.604752148,2005
Broward,1740987,44870,0.025772737,1696117,0.974227263,2005
Calhoun,13945,10933,0.784008605,3012,0.215991395,2005
Charlotte,154030,137775,0.89446861,16255,0.10553139,2005
Citrus,132635,121717,0.917683869,10918,0.082316131,2005
Clay,169623,152343,0.898127023,17280,0.101872977,2005
Collier,317788,279124,0.878333984,38664,0.121666016,2005
Columbia,61466,50341,0.819005629,11125,0.180994371,2005
DeSoto,32606,25938,0.795497761,6668,0.204502239,2005
Dixie,15377,13342,0.867659491,2035,0.132340509,2005
Duval,861150,0,0.0,861150,1.0,2005
Escambia,303623,247012,0.813548381,56611,0.186451619,2005
Flagler,78617,12068,0.153503695,66549,0.846496305,2005
Franklin,10845,7061,0.651083449,3784,0.348916551,2005
Gadsden,47713,30725,0.643954478,16988,0.356045522,2005
Gilchrist,16221,13786,0.84988595,2435,0.15011405,2005
Glades,10729,9074,0.845745177,1655,0.154254823,2005
Gulf,16479,11044,0.670186298,5435,0.329813702,2005
Hamilton,14315,10975,0.766678309,3340,0.233321691,2005
Hardee,27333,18626,0.681447335,8707,0.318552665,2005
Hendry,38376,27208,0.708984782,11168,0.291015218,2005
Hernando,150784,143497,0.951672591,7287,0.048327409,2005
Highlands,93456,72793,0.778901301,20663,0.221098699,2005
Hillsborough,1131546,750599,0.66333936,380947,0.33666064,2005
Holmes,19157,15114,0.788954429,4043,0.211045571,2005
Indian River,130043,83822,0.644571411,46221,0.355428589,2005
Jackson,49691,32757,0.659213942,16934,0.340786058,2005
Jefferson,14233,11679,0.820557858,2554,0.179442142,2005
Lafayette,7971,6955,0.87253795,1016,0.12746205,2005
Lake,263017,146221,0.555937449,116796,0.444062551,2005
Lee,549442,292414,0.532201761,257028,0.467798239,2005
Leon,271111,96330,0.355315719,174781,0.644684281,2005
Levy,37985,28295,0.744899302,9690,0.255100698,2005
Liberty,7581,6639,0.875741987,942,0.124258013,2005
Madison,19696,15350,0.77934606,4346,0.22065394,2005
Manatee,304364,225722,0.741618588,78642,0.258381412,2005
Marion,304926,248768,0.815830726,56158,0.184169274,2005
Martin,141059,121516,0.861455136,19543,0.138544864,2005
Miami-Dade,2422075,1134686,0.468476823,1287389,0.531523177,2005
Monroe,82413,37164,0.450948273,45249,0.549051727,2005
Nassau,65759,49944,0.759500601,15815,0.240499399,2005
Okaloosa,188939,112354,0.594657535,76585,0.405342465,2005
Okeechobee,37765,32322,0.855871839,5443,0.144128161,2005
Orange,1043437,677185,0.648994621,366252,0.351005379,2005
Osceola,235156,152233,0.647370256,82923,0.352629744,2005
Palm Beach,1265900,559438,0.441929062,706462,0.558070938,2005
Pasco,406898,366570,0.900889166,40328,0.099110834,2005
Pinellas,947744,283059,0.298666095,664685,0.701333905,2005
Polk,541840,338250,0.624261775,203590,0.375738225,2005
Putnam,73764,57947,0.785572908,15817,0.214427092,2005
St. Johns,157278,137415,0.873707702,19863,0.126292298,2005
St. Lucie,240039,71711,0.298747287,168328,0.701252713,2005
Santa Rosa,136443,122654,0.898939484,13789,0.101060516,2005
Sarasota,367867,246147,0.669119546,121720,0.330880454,2005
Seminole,411744,203021,0.493075795,208723,0.506924205,2005
Sumter,74052,65306,0.881893804,8746,0.118106196,2005
Suwannee,38174,30908,0.809661026,7266,0.190338974,2005
Taylor,21310,14478,0.679399343,6832,0.320600657,2005
Union,15046,12384,0.823075901,2662,0.176924099,2005
Volusia,494649,114961,0.232409244,379688,0.767590756,2005
Wakulla,26867,26143,0.973052444,724,0.026947556,2005
Walton,53525,46230,0.863708547,7295,0.136291453,2005
Washington,23097,17661,0.764644759,5436,0.235355241,2005
Alachua,236174,98755,0.418145096,137419,0.581854904,2004
Baker,23963,18456,0.770187372,5507,0.229812628,2004
Bay,158437,62762,0.396132217,95675,0.603867783,2004
Bradford,27740,20706,0.746431146,7034,0.253568854,2004
Brevard,521422,208239,0.399367499,313183,0.600632501,2004
Broward,1723131,83359,0.048376473,1639772,0.951623527,2004
Calhoun,13610,10610,0.779573843,3000,0.220426157,2004
Charlotte,156985,139817,0.890639233,17168,0.109360767,2004
Citrus,129110,118320,0.916427852,10790,0.083572148,2004
Clay,163461,146401,0.895632597,17060,0.104367403,2004
Collier,306186,267640,0.874109202,38546,0.125890798,2004
Columbia,60453,49373,0.816717119,11080,0.183282881,2004
DeSoto,34105,27251,0.7990324,6854,0.2009676,2004
Dixie,14928,12882,0.862942122,2046,0.137057878,2004
Duval,840474,0,0.0,840474,1.0,2004
Escambia,307226,249132,0.810907931,58094,0.189092069,2004
Flagler,69683,10983,0.157613765,58700,0.842386235,2004
Franklin,10649,6931,0.650859236,3718,0.349140764,2004
Gadsden,46857,30185,0.644194037,16672,0.355805963,2004
Gilchrist,15900,13511,0.849748428,2389,0.150251572,2004
Glades,10733,9083,0.846268518,1650,0.153731482,2004
Gulf,16171,10782,0.666749119,5389,0.333250881,2004
Hamilton,14303,10988,0.768230441,3315,0.231769559,2004
Hardee,27787,18648,0.671105193,9139,0.328894807,2004
Hendry,37394,26297,0.703241162,11097,0.296758838,2004
Hernando,145207,137920,0.949816469,7287,0.050183531,2004
Highlands,92057,71531,0.777029449,20526,0.222970551,2004
Hillsborough,1108435,730821,0.659326889,377614,0.340673111,2004
Holmes,19012,15035,0.790816327,3977,0.209183673,2004
Indian River,126829,81217,0.640366162,45612,0.359633838,2004
Jackson,48870,32275,0.660425619,16595,0.339574381,2004
Jefferson,14064,11527,0.819610353,2537,0.180389647,2004
Lafayette,7535,6513,0.864366291,1022,0.135633709,2004
Lake,251878,141203,0.560600767,110675,0.439399233,2004
Lee,521253,276939,0.531294784,244314,0.468705216,2004
Leon,263896,94760,0.35908085,169136,0.64091915,2004
Levy,37486,28263,0.753961479,9223,0.246038521,2004
Liberty,7354,6412,0.871906445,942,0.128093555,2004
Madison,19498,15169,0.777977228,4329,0.222022772,2004
Manatee,295242,218616,0.740463755,76626,0.259536245,2004
Marion,293317,239352,0.816018165,53965,0.183981835,2004
Martin,137637,118650,0.862050175,18987,0.137949825,2004
Miami-Dade,2379818,1098940,0.461774808,1280878,0.538225192,2004
Monroe,81236,36606,0.450613029,44630,0.549386971,2004
Nassau,65016,49481,0.761058816,15535,0.238941184,2004
Okaloosa,185778,110966,0.597304309,74812,0.402695691,2004
Okeechobee,38004,32546,0.856383539,5458,0.143616461,2004
Orange,1013937,662530,0.65342324,351407,0.34657676,2004
Osceola,225816,145568,0.644631027,80248,0.355368973,2004
Palm Beach,1242270,557228,0.448556272,685042,0.551443728,2004
Pasco,389776,350110,0.898233857,39666,0.101766143,2004
Pinellas,943640,284306,0.301286508,659334,0.698713492,2004
Polk,528389,328359,0.621434209,200030,0.378565791,2004
Putnam,73226,57727,0.788340207,15499,0.211659793,2004
St. Johns,149336,129759,0.868906359,19577,0.131093641,2004
St. Lucie,226216,71389,0.315578916,154827,0.684421084,2004
Santa Rosa,133721,119833,0.896141967,13888,0.103858033,2004
Sarasota,358307,242852,0.67777632,115455,0.32222368,2004
Seminole,403361,199482,0.494549547,203879,0.505450453,2004
Sumter,66416,57811,0.870437846,8605,0.129562154,2004
Suwannee,37713,30475,0.80807679,7238,0.19192321,2004
Taylor,20941,14118,0.674179839,6823,0.325820161,2004
Union,14620,11937,0.816484268,2683,0.183515732,2004
Volusia,484261,113678,0.234745313,370583,0.765254687,2004
Wakulla,25505,24784,0.971731033,721,0.028268967,2004
Walton,50543,43412,0.858912213,7131,0.141087787,2004
Washington,22434,17070,0.760898636,5364,0.239101364,2004
Alachua,231296,95161,0.411425187,136135,0.588574813,2003
Baker,23383,18035,0.771286832,5348,0.228713168,2003
Bay,154827,61258,0.395654505,93569,0.604345495,2003
Bradford,26972,19999,0.741472638,6973,0.258527362,2003
Brevard,507810,204689,0.403081861,303121,0.596918139,2003
Broward,1698425,88063,0.051849802,1610362,0.948150198,2003
Calhoun,13439,10469,0.779001414,2970,0.220998586,2003
Charlotte,151994,135403,0.890844375,16591,0.109155625,2003
Citrus,125804,115128,0.915137833,10676,0.084862167,2003
Clay,156011,139229,0.892430662,16782,0.107569338,2003
Collier,292466,254255,0.869348916,38211,0.130651084,2003
Columbia,58890,47830,0.812192223,11060,0.187807777,2003
DeSoto,33713,26853,0.796517664,6860,0.203482336,2003
Dixie,14688,12632,0.860021786,2056,0.139978214,2003
Duval,826279,0,0.0,826279,1.0,2003
Escambia,303310,245268,0.808638027,58042,0.191361973,2003
Flagler,61541,10600,0.172242895,50941,0.827757105,2003
Franklin,10480,6790,0.647900763,3690,0.352099237,2003
Gadsden,46491,29535,0.635284249,16956,0.364715751,2003
Gilchrist,15517,13214,0.851582136,2303,0.148417864,2003
Glades,10729,9053,0.843787865,1676,0.156212135,2003
Gulf,15615,10257,0.656868396,5358,0.343131604,2003
Hamilton,14025,10635,0.75828877,3390,0.24171123,2003
Hardee,27400,18419,0.672226277,8981,0.327773723,2003
Hendry,36511,25600,0.701158555,10911,0.298841445,2003
Hernando,140670,133365,0.948069951,7305,0.051930049,2003
Highlands,90393,70258,0.777250451,20135,0.222749549,2003
Hillsborough,1079587,707626,0.655459912,371961,0.344540088,2003
Holmes,18940,14966,0.790179514,3974,0.209820486,2003
Indian River,121174,76908,0.63469061,44266,0.36530939,2003
Jackson,48991,32613,0.665693699,16378,0.334306301,2003
Jefferson,13552,11019,0.813090319,2533,0.186909681,2003
Lafayette,7353,6341,0.862369101,1012,0.137630899,2003
Lake,240716,135518,0.56297878,105198,0.43702122,2003
Lee,495088,269200,0.543741719,225888,0.456258281,2003
Leon,255500,93190,0.364735812,162310,0.635264188,2003
Levy,36664,27595,0.752645647,9069,0.247354353,2003
Liberty,7227,6295,0.871039159,932,0.128960841,2003
Madison,19139,14825,0.774596374,4314,0.225403626,2003
Manatee,286884,210813,0.734837077,76071,0.265162923,2003
Marion,281966,228313,0.809718193,53653,0.190281807,2003
Martin,134491,116162,0.863715788,18329,0.136284212,2003
Miami-Dade,2345932,1215197,0.518001801,1130735,0.481998199,2003
Monroe,80537,36399,0.45195376,44138,0.54804624,2003
Nassau,63062,47930,0.760045669,15132,0.239954331,2003
Okaloosa,181102,108157,0.597215934,72945,0.402784066,2003
Okeechobee,37236,31784,0.853582555,5452,0.146417445,2003
Orange,983165,645092,0.656138085,338073,0.343861915,2003
Osceola,210438,134260,0.638002642,76178,0.361997358,2003
Palm Beach,1211448,554082,0.457371674,657366,0.542628326,2003
Pasco,375318,336478,0.896514422,38840,0.103485578,2003
Pinellas,939864,284932,0.303163011,654932,0.696836989,2003
Polk,511929,316613,0.61847053,195316,0.38152947,2003
Putnam,71971,56778,0.788901085,15193,0.211098915,2003
St. Johns,139849,120773,0.863595735,19076,0.136404265,2003
St. Lucie,211898,69472,0.327855855,142426,0.672144145,2003
Santa Rosa,128889,115271,0.894343195,13618,0.105656805,2003
Sarasota,348761,238613,0.684173402,110148,0.315826598,2003
Seminole,394900,194878,0.493486959,200022,0.506513041,2003
Sumter,63001,54560,0.866018,8441,0.133982,2003
Suwannee,37198,29976,0.805849777,7222,0.194150223,2003
Taylor,20646,13822,0.669475928,6824,0.330524072,2003
Union,13726,11354,0.827189276,2372,0.172810724,2003
Volusia,470770,111783,0.237447161,358987,0.762552839,2003
Wakulla,24938,24256,0.972652177,682,0.027347823,2003
Walton,47066,40002,0.849912888,7064,0.150087112,2003
Washington,21913,16669,0.760690001,5244,0.239309999,2003
Alachua,228607,111939,0.489656922,116668,0.510343078,2002
Baker,22992,17818,0.774965205,5174,0.225034795,2002
Bay,152186,60135,0.395141472,92051,0.604858528,2002
Bradford,26517,19410,0.731983256,7107,0.268016744,2002
Brevard,494102,198121,0.400971864,295981,0.599028136,2002
Broward,1669153,95415,0.057163723,1573738,0.942836277,2002
Calhoun,13231,10229,0.773108609,3002,0.226891391,2002
Charlotte,148521,132401,0.89146316,16120,0.10853684,2002
Citrus,123008,112627,0.915607115,10381,0.084392885,2002
Clay,149901,133304,0.889280258,16597,0.110719742,2002
Collier,277457,240093,0.865334088,37364,0.134665912,2002
Columbia,58372,47683,0.816881381,10689,0.183118619,2002
DeSoto,32798,26020,0.793341057,6778,0.206658943,2002
Dixie,14459,12396,0.8573207,2063,0.1426793,2002
Duval,809394,0,0.0,809394,1.0,2002
Escambia,299485,241453,0.806227357,58032,0.193772643,2002
Flagler,56785,10378,0.182759532,46407,0.817240468,2002
Franklin,10161,6554,0.645015254,3607,0.354984746,2002
Gadsden,45911,29948,0.652305548,15963,0.347694452,2002
Gilchrist,15023,12734,0.847633628,2289,0.152366372,2002
Glades,10664,9001,0.844054764,1663,0.155945236,2002
Gulf,15202,9829,0.646559663,5373,0.353440337,2002
Hamilton,13925,10515,0.755116697,3410,0.244883303,2002
Hardee,27437,18444,0.672230929,8993,0.327769071,2002
Hendry,36154,25368,0.701665099,10786,0.298334901,2002
Hernando,136484,129212,0.946719029,7272,0.053280971,2002
Highlands,89038,69011,0.775073564,20027,0.224926436,2002
Hillsborough,1055617,690391,0.654016561,365226,0.345983439,2002
Holmes,18708,14646,0.782873637,4062,0.217126363,2002
Indian River,118149,75039,0.635121753,43110,0.364878247,2002
Jackson,47707,31528,0.660867378,16179,0.339132622,2002
Jefferson,13261,10716,0.808083855,2545,0.191916145,2002
Lafayette,7205,6195,0.85981957,1010,0.14018043,2002
Lake,231072,131010,0.56696614,100062,0.43303386,2002
Lee,475073,258467,0.54405744,216606,0.45594256,2002
Leon,248039,91336,0.368232415,156703,0.631767585,2002
Levy,36013,27023,0.750367923,8990,0.249632077,2002
Liberty,7157,6169,0.861953332,988,0.138046668,2002
Madison,18932,14657,0.774191844,4275,0.225808156,2002
Manatee,277362,203605,0.734076766,73757,0.265923234,2002
Marion,271096,218238,0.8050211,52858,0.1949789,2002
Martin,131051,113008,0.862320776,18043,0.137679224,2002
Miami-Dade,2312478,1223571,0.529116818,1088907,0.470883182,2002
Monroe,81140,36772,0.453192014,44368,0.546807986,2002
Nassau,61094,46372,0.759027073,14722,0.240972927,2002
Okaloosa,176971,105334,0.595204864,71637,0.404795136,2002
Okeechobee,36551,31155,0.85237066,5396,0.14762934,2002
Orange,955865,631450,0.660605839,324415,0.339394161,2002
Osceola,193355,120552,0.623474955,72803,0.376525045,2002
Palm Beach,1183197,545492,0.461032271,637705,0.538967729,2002
Pasco,361468,323321,0.894466453,38147,0.105533547,2002
Pinellas,933994,285490,0.305665775,648504,0.694334225,2002
Polk,502385,311853,0.620745046,190532,0.379254954,2002
Putnam,71329,56418,0.790954591,14911,0.209045409,2002
St. Johns,133953,115395,0.86145887,18558,0.13854113,2002
St. Lucie,203360,67674,0.332779308,135686,0.667220692,2002
Santa Rosa,124956,111412,0.891609847,13544,0.108390153,2002
Sarasota,339684,234601,0.690644835,105083,0.309355165,2002
Seminole,387626,191110,0.493026784,196516,0.506973216,2002
Sumter,61348,52965,0.863353329,8383,0.136646671,2002
Suwannee,35727,28532,0.798611694,7195,0.201388306,2002
Taylor,19800,12973,0.65520202,6827,0.34479798,2002
Union,13794,11421,0.827968682,2373,0.172031318,2002
Volusia,459737,109196,0.237518407,350541,0.762481593,2002
Wakulla,24217,23531,0.971672792,686,0.028327208,2002
Walton,45521,38474,0.845192329,7047,0.154807671,2002
Washington,21649,16359,0.755646912,5290,0.244353088,2002
Alachua,222935,108532,0.486832485,114403,0.513167515,2001
Baker,22562,17492,0.775285879,5070,0.224714121,2001
Bay,150287,58994,0.392542269,91293,0.607457731,2001
Bradford,26080,18973,0.727492331,7107,0.272507669,2001
Brevard,485178,193121,0.398041544,292057,0.601958456,2001
Broward,1649925,112605,0.068248557,1537320,0.931751443,2001
Calhoun,13073,10077,0.770825365,2996,0.229174635,2001
Charlotte,144571,129335,0.894612336,15236,0.105387664,2001
Citrus,120471,110185,0.914618456,10286,0.085381544,2001
Clay,142838,126420,0.885058598,16418,0.114941402,2001
Collier,264475,227234,0.859188959,37241,0.140811041,2001
Columbia,57066,46628,0.817088985,10438,0.182911015,2001
DeSoto,32736,26002,0.794293744,6734,0.205706256,2001
Dixie,14059,11994,0.853118999,2065,0.146881001,2001
Duval,793898,0,0.0,793898,1.0,2001
Escambia,296709,238671,0.804394204,58038,0.195605796,2001
Flagler,53061,9917,0.186898098,43144,0.813101902,2001
Franklin,11197,7569,0.675984639,3628,0.324015361,2001
Gadsden,45284,29141,0.643516474,16143,0.356483526,2001
Gilchrist,14699,12425,0.845295598,2274,0.154704402,2001
Glades,10612,8952,0.843573313,1660,0.156426687,2001
Gulf,14952,9595,0.641720171,5357,0.358279829,2001
Hamilton,13731,10328,0.75216663,3403,0.24783337,2001
Hardee,26921,18015,0.669180194,8906,0.330819806,2001
Hendry,36302,25542,0.703597598,10760,0.296402402,2001
Hernando,132762,125523,0.945473855,7239,0.054526145,2001
Highlands,88212,68288,0.774135038,19924,0.225864962,2001
Hillsborough,1026906,666536,0.649072067,360370,0.350927933,2001
Holmes,18714,14680,0.784439457,4034,0.215560543,2001
Indian River,115716,73458,0.634812818,42258,0.365187182,2001
Jackson,47495,31346,0.659985262,16149,0.340014738,2001
Jefferson,13043,10517,0.806332899,2526,0.193667101,2001
Lafayette,7057,6056,0.858155023,1001,0.141844977,2001
Lake,220323,126253,0.573035952,94070,0.426964048,2001
Lee,454918,247287,0.543585877,207631,0.456414123,2001
Leon,244208,90550,0.370790474,153658,0.629209526,2001
Levy,35118,26317,0.749387778,8801,0.250612222,2001
Liberty,7132,6203,0.869742008,929,0.130257992,2001
Madison,18862,14560,0.771922384,4302,0.228077616,2001
Manatee,270771,197350,0.728844669,73421,0.271155331,2001
Marion,264277,211582,0.800606939,52695,0.199393061,2001
Martin,128873,111056,0.861747612,17817,0.138252388,2001
Miami-Dade,2285869,1206210,0.527681158,1079659,0.472318842,2001
Monroe,80588,36511,0.453057527,44077,0.546942473,2001
Nassau,59409,44577,0.750340857,14832,0.249659143,2001
Okaloosa,173450,102818,0.592781781,70632,0.407218219,2001
Okeechobee,36147,30768,0.85119097,5379,0.14880903,2001
Orange,930034,619597,0.666208977,310437,0.333791023,2001
Osceola,179534,109190,0.608185636,70344,0.391814364,2001
Palm Beach,1154464,531434,0.460329642,623030,0.539670358,2001
Pasco,352380,314593,0.892766332,37787,0.107233668,2001
Pinellas,929208,284867,0.306569681,644341,0.693430319,2001
Polk,496112,309744,0.62434289,186368,0.37565711,2001
Putnam,70820,56145,0.792784524,14675,0.207215476,2001
St. Johns,128604,110372,0.85823147,18232,0.14176853,2001
St. Lucie,198253,67145,0.338683399,131108,0.661316601,2001
Santa Rosa,121370,107881,0.888860509,13489,0.111139491,2001
Sarasota,334023,231939,0.694380327,102084,0.305619673,2001
Seminole,377960,186521,0.493494021,191439,0.506505979,2001
Sumter,56932,48575,0.853210848,8357,0.146789152,2001
Suwannee,35695,28527,0.799187561,7168,0.200812439,2001
Taylor,19521,12674,0.649249526,6847,0.350750474,2001
Union,13521,11251,0.832113009,2270,0.167886991,2001
Volusia,452050,107916,0.238725805,344134,0.761274195,2001
Wakulla,23807,23126,0.971394968,681,0.028605032,2001
Walton,42542,35598,0.836773071,6944,0.163226929,2001
Washington,21437,16167,0.754163362,5270,0.245836638,2001
